
* * * * * * * * * * * * * * * * * * * * * * * * * * * * * * * * * * * * * * * * * * * * * * * * * * * 
*                   *       *   *                       *                       *         E         * 
* * * * * * * * *   *   *   *   *   * * * * * * *   * * *   * * * * * * *   *   * * * * *   * * *   * 
*           *   *   *   *       *   *           *       *   *   *           *               *       * 
*   * * * * *   *   *   * * * * *   *   * * * * * * *   *   *   *   * * * * * * * * * * * * *   * * * 
*   *       *   *   *       *       *               *       *   *           *               *       * 
*   *   *   *   *   * * *   *   * * * * * * *   *   * * * * *   * * * * *   *   * * * * *   * * *   * 
*       *   *               *               *   *                   *       *   *       *   *   *   * 
* * * * *   * * * * * * * * * * * * * * *   *   *   * * * * * * * * *   *   *   *   * * *   *   *   * 
*           *               *           *   *   *       *       *       *   *       *       *       * 
*   *   * * *   * * * * *   *   *   *   *   * * *   *   *   *   *   * * *   * * *   *   * * * * * * * 
*   *   *       *       *   *   *   *   *       *   *       *   *   *       *       *               * 
*   * * *   * * * * *   *   *   *   *   * * *   *   * * * * *   *   * * * * *   * * * * * * * * *   * 
*   *       *           *       *   *   *   *   *   *           *   *           *   *               * 
*   *   * * *   *   * * * * * * *   *   *   *   * * *   * * *   *   *   * * * * *   *   * * * * * * * 
*       *       *   *       *       *       *   *       *       *   *           *   *               * 
*   * * *   *   *   *   *   *   *   * * * * *   *   * * *   * * *   * * * * *   *   * * * * *   *   * 
*   *       *   *   *   *       *   *       *   *   *       *           *       *       * S *   *   * 
*   * * * * *   *   *   * * * * * * *   *   *   *   * * * * *   * * * * *   * * *   *   *   * * *   * 
*       *       *   *                   *           *       *           *   *       *   *   *       * 
* * *   *   * * * * * * * * * * * * * * * * * * * * *   *   * * * * *   *   *   * * *   *   *   * * * 
*   *   *                   *               *           *               *   *   *   *   *       *   * 
*   *   *   * * * * *   *   * * * * * * *   *   * * * * *   * * * * * * *   *   *   *   * * * * *   * 
*   *   *           *   *                   *       *   *   *           *       *       *   *       * 
*   *   * * * * *   *   * * *   * * * * * * * * *   *   *   *   * * *   * * * * *   * * *   *   *   * 
*   *   *           *   *       *                   *   *   *   *   *       *       *   *       *   * 
*   *   * * * * * * *   *   * * *   * * * * * * * * *   *   *   *   *   * * *   * * *   *   * * *   * 
*   *       *           *       *       *                   *       *           *   *           *   * 
*   * * *   *   * * * * *   * * * * *   * * * * * * * * *   * * *   * * * * * * *   *   * * * * *   * 
*           *   *       *   *           *               *       *   *           *       *       *   * 
*   * * * * *   *   *   *   *   * * *   *   * * * * *   *   * * *   *   *   *   * * *   *   *   *   * 
*   *           *   *       *   * E     *   *   *       *   *       *   *   *       *   *   *   *   * 
*   *   * * * * * * * * *   *   * * * * *   *   *   * * * * *   * * *   *   * * *   *   *   *   *   * 
*   *       *           *   *       *       *   *               *       *   *   *   *   *   *   *   * 
*   * * *   *   * * *   *   * * *   *   * * *   * * * * * * * * * * * * *   *   *   * * *   *   *   * 
*           *       *   *   *       *       *                   *           *   *           *       * 
* * * * *   * * *   *   * * *   * * * * *   *   * * * * *   *   *   * * * * *   * * * * * * * * *   * 
*           *       *           *           *   *           *       *                   *   *       * 
*   * * * * *   * * * * * * * * *   * * * * * * *   * * * * * * * * *   * * * * *   *   *   *   * * * 
*           *       *               *               *                   *           *       *   *   * 
* * * * *   * * *   *   * * * * * * *   *   * * * * * * *   * * * * * * *   * * *   * * * * *   *   * 
*               *   *           *       *   *           *       *           *       *           *   * 
* * * * * * *   *   * * * * *   *   *   * * *   * * *   *   * * *   *   * * * * * * *   * * * * *   * 
*           *   *           *   *   *               *   *   *       *   *           *       *       * 
*   * * *   * * *   * * *   *   *   * * * * * * * * *   *   *   *   * * *   * * *   * * *   * * *   * 
*   *               *       *   *       *           *   *   *   *   *       *   *       *           * 
*   *   * * * * * * * * * * *   * * *   *   * * *   *   *   *   * * *   * * *   *   * * * * * * *   * 
*   *   *       *           *   *       *   *   *       *   *       *           *   *           *   * 
*   * * *   *   *   * * *   *   * * * * *   *   * * * * *   * * *   * * * * *   *   *   *   * * *   * 
*           *           *                   *                   *               *       *           * 
* * * * * * * * * * * * * * * * * * * * * * * * * * * * * * * * * * * * * * * * * * * * * * * * * * * 