
* * * * * * * * * * * * * * * * * * * * * * * * * * * * * * * * * * * * * * * * * * * * * * * * * * * 
* E     *       *   *                                   *   *           *               *         E * 
*   *   *   *   *   *   * * * * *   * * * * * * *   *   *   *   *   * * *   * * *   *   * * * * *   * 
*   *   *   *       *   *       *   *               *   *       *               *   *               * 
*   *   *   *   * * *   *   *   * * *   * * * * * * *   * * * * * * * * * * * * *   * * * * * * *   * 
*   *       *   *       *   *       *           *   *   *       *           *       *           *   * 
*   * * * * * * *   * * *   * * *   * * * * *   *   *   *   *   *   * * *   *   * * *   *   * * *   * 
*       *           *   *   *                   *           *       *   *       *       *   *       * 
*   *   *   * * * * *   *   * * * * * * * * *   * * * * * * * * * * *   * * * * *   *   *   *   * * * 
*   *   *   *           *           *           *       *       *           *       *   *   *   *   * 
*   *   *   *   *   *   * * * * *   * * * * * * *   *   * * *   *   * * *   *   * * *   * * *   *   * 
*   *       *   *   *           *                   *       *   *       *   *   *   *   *       *   * 
*   * * * * * * *   * * * * * * *   * * * * * * * * * * *   *   *   * * *   *   *   *   *   * * *   * 
*   *               *           *       *           *       *   *   *       *   *   *       *       * 
*   * * *   * * *   *   * * *   * * *   *   * * *   *   * * *   *   *   * * *   *   * * * * *   *   * 
*       *   *       *   *           *   *   *       *   *       *   *           *           *   *   * 
* * *   *   *   * * *   * * * * *   *   *   *   * * *   *   * * *   * * * * * * *   * * *   *   *   * 
*   *       *   *   *       *   *   *       *   *   *   *       *   *               *   *   *   *   * 
*   * * * * *   *   * * *   *   *   * * * * *   *   *   *   *   *   * * *   * * * * *   *   *   *   * 
*   *           *       *   *   *   *       *       *   *   *               *       *   *   *   *   * 
*   *   * * * * * * *   *   *   *   *   *   * * * * *   * * *   * * * * * * *   *   *   *   *   *   * 
*   *   *               *   *       *   *   *       *       *   *               *   *           *   * 
*   *   *   * * * * *   *   * * *   *   *   *   *   *   *   * * *   * * * * * * *   * * * * * * *   * 
*   *   *       *       *       *       *       *   *   *   *       *           *       *       *   * 
*   *   * * *   *   * * * * *   * * * * * * * * *   *   *   *   * * * * * * *   * * *   *   * * *   * 
*   *   *       *           *       *       *       *   *       *               *   *   *           * 
*   *   *   * * * * * * * * * * *   *   *   *   * * *   * * * * *   * * * * *   *   *   * * *   * * * 
*   *       *                       *   *       *               *   *               *       *   *   * 
*   * * *   *   * * * * * * * * * * *   * * * * * * * * * * *   *   * * * * * * *   * * *   *   *   * 
*       *   *       *       *       *   *           *   *           *           *       *   *   *   * 
*   *   *   * * *   *   * * *   *   *   *   * * *   *   *   * * * * *   * * *   * * * * *   *   *   * 
*   *   *   *       *           *       *       *   *   *   *   *       *   *           *   *       * 
*   * * *   *   *   * * * * *   * * * * * * *   *   *   *   *   *   * * *   * * * * *   *   * * *   * 
*           *   *   *       *       *           *   *           *   *               *       *       * 
*   * * * * *   * * *   *   * * *   *   * * * * *   * * * * *   *   *   * * *   *   * * * * *   * * * 
*           *       *   *       *       *       *       *       *   *       *   *   *   *       * E * 
*   * * * * * * *   *   * * *   * * * * *   * * * * *   *   * * *   *   * * *   *   *   *   * * *   * 
*   *               *       *   * S     *               *   *       *   *       *   *   *           * 
* * *   * * * * *   * * *   *   * * *   *   * * * * * * *   *   * * * * *   * * *   *   * * * * *   * 
*       *               *   *           *   *       *   *   *           *       *               *   * 
*   * * * * *   * * * * *   * * * * * * *   *   *   *   *   * * * * *   *   *   * * * * * * *   *   * 
*   *       *   *           *           *       *   *           *       *   *   *       *       *   * 
*   *   *   *   *   * * * * *   *   * * * * * * *   * * * * * * *   * * * * *   * * *   *   * * *   * 
*   *   *   *   *           *   *               *               *           *       *           *   * 
*   *   *   *   * * * * *   * * * * *   *   * * * * * * * * *   * * * * *   *   *   * * * * *   *   * 
*       *   *           *   *       *   *           *           *           *   *           *   *   * 
*   * * *   * * * * * * *   *   *   *   * * * * *   *   * * * * *   * * * * *   * * * * *   * * *   * 
*       *               *       *   *   *       *       *           *           *       *       *   * 
* * *   * * * * * * *   * * * * *   *   *   *   * * * * * * * * *   *   * * * * * * *   * * *   *   * 
*                   *               *       *                       *                       *       * 
* * * * * * * * * * * * * * * * * * * * * * * * * * * * * * * * * * * * * * * * * * * * * * * * * * * 