
* * * * * * * * * * * * * * * * * * * * * * * * * * * * * * * * * * * * * * * * * * * * * * * * * * * 
* S     *                   *       *           *           *                   *       *         E * 
*   *   * * * * *   * * *   *   *   *   * * * * *   * * *   *   * * * * *   *   *   *   *   * * *   * 
*   *           *       *       *       *           *   *   *   *       *   *       *       *   *   * 
*   * * * * *   * * *   * * *   * * * * *   * * * * *   *   *   *   *   *   * * * * * * * * *   *   * 
*   *       *           *   *   *           *           *       *   *   *       *               *   * 
*   *   *   * * * * * * *   *   *   * * * * *   * * *   * * * * *   *   * * *   * * * * *   *   *   * 
*   *   *   *       *           *   *           *   *   *           *       *       *       *   *   * 
*   * * *   *   *   *   * * * * *   *   * * * * *   *   *   * * *   * * *   * * *   *   * * *   *   * 
*   *       *   *           *       *   *   *           *   *       *       *       *       *   *   * 
*   *   *   *   * * * * * * *   * * *   *   *   * * * * *   *   * * *   * * *   * * *   *   *   *   * 
*   *   *   *   *               *       *   *   *   *       *   *   *   *       *       *   *   *   * 
*   *   * * *   *   * * * * * * * * *   *   *   *   *   * * *   *   *   *   * * * * * * *   * * *   * 
*   *           *   *                   *   *   *       *       *   *   *               *           * 
*   *   * * * * *   *   * * * * * * * * *   *   * * *   *   * * *   *   * * * * * * *   * * * * * * * 
*   *   *       *       *           *       *       *   *   *           *           *   *           * 
*   * * *   *   * * * * * * *   *   *   *   * * *   * * *   *   * * * * * * *   *   *   *   * * *   * 
*           *               *   *   *   *       *           *           *       *   *   *   *   *   * 
*   * * * * * * * * *   *   *   *   * * *   *   * * * * * * * * * * *   *   * * * * *   *   *   *   * 
*   *               *   *       *           *       *       *           *   *       *           *   * 
*   * * *   * * *   *   *   * * * * * * * * * * *   * * *   *   * * * * *   *   *   * * * * * * *   * 
*       *   *       *   *   *                   *           *   *       *   *   *   *               * 
* * *   *   * * * * *   * * *   * * * * * * *   * * * * * * *   *   *   *   *   *   *   * * * * *   * 
*       *   *           *       *           *                   *   *       *   *       *       *   * 
*   * * *   *   * * * * *   * * *   *   * * * * * * * * *   * * *   * * *   *   * * * * *   * * *   * 
*   *       *               *       *   *       *       *           *       *       *       *       * 
*   *   *   * * * * * * * * * * * * *   *   *   *   *   * * * * * * *   * * * * *   * * *   *   * * * 
*       *   *                           *   *       *       *       *           *       *       *   * 
* * * * *   * * *   * * * * * * *   * * *   * * * * * * *   *   *   * * * * * * * * *   * * *   *   * 
*   *       *       *               *       *           *       *   *               *       *       * 
*   *   * * *   * * *   * * * * * * *   * * * * * * *   * * * * *   *   * * * * *   *   *   * * * * * 
*   *   *       *                   *   *                   *   *   *       *       *   *           * 
*   *   *   *   * * * * * * *   * * *   *   * * * * * * *   *   *   * * *   *   * * * * * * *   *   * 
*   *   *   *       *           *       *   *       *           *       *   *               *   *   * 
*   *   * * * * *   * * * * * * *   * * *   *   *   * * * * * * * * *   *   * * * * * * *   * * *   * 
*   *   *           *       *       *       *   *                   *   *               *       *   * 
*   *   *   * * * * *   *   *   * * *   *   *   * * * * * * * * *   *   *   * * * * *   * * *   *   * 
*           *           *       *   *   *   *       *           *       *       *       *   *       * 
*   * * * * *   * * * * * * * * *   *   *   * * *   * * *   *   * * * * * * * * *   * * *   * * *   * 
*       *       *       *               *               *   *                   *       *           * 
* * * * *   * * *   * * *   * * * * * * * * * * * * *   *   * * *   * * * * *   *   *   *   * * * * * 
*           *   *           *       *           *   *   *   *       *   *       *   *   *           * 
*   * * * * *   *   * * * * *   *   *   * * *   *   *   * * *   * * *   *   * * * * *   * * * * *   * 
*       *   *       *       *   *   *       *   *   *       *   *       *               *       *   * 
*   *   *   *   * * *   *   *   *   * * *   *   *   * * *   *   *   *   * * * * * * * * *   *   *   * 
*   *   *   *   *       *       *           *   *       *   *   *   *   *           *       *       * 
*   *   *   *   *   * * * * * * * * * * * * *   *   * * *   *   * * *   *   * * *   *   * * * * * * * 
*   *   *       *   *                       *   *               *   *       *   *       *           * 
*   *   * * * * *   * * * * * * * * * * *   *   * * * * * * * * *   *   * * *   * * * * *   * * *   * 
* E *                                       *                       *                       * E     * 
* * * * * * * * * * * * * * * * * * * * * * * * * * * * * * * * * * * * * * * * * * * * * * * * * * * 