
* * * * * * * * * * * * * * * * * * * * * * * * * * * * * * * * * * * * * * * * * * * * * * * * * * * 
* S *                               *           *           *       *           *       *         E * 
*   *   * * * * * * *   * * * * *   *   *   * * *   *   *   *   *   *   *   *   *   *   * * *   *   * 
*   *   *           *           *   *   *   *       *   *       *   *   *   *       *       *   *   * 
*   *   *   *   *   * * * * *   *   * * *   *   * * *   * * * * *   * * *   * * * * * * *   *   * * * 
*       *   *   *           *   *           *   *       *       *           *           *   *       * 
*   * * * * *   * * * * * * *   * * * * *   *   *   * * * * *   * * * * * * *   *   *   *   * * *   * 
*               *               *   *       *   *       *                   *   *   *   *       *   * 
* * * * * * *   *   * * * * * * *   *   * * *   * * *   *   *   * * * * * * *   *   * * * * *   *   * 
*           *   *               *       *       *       *   *   *           *   *           *   *   * 
* * *   * * *   * * * * * * *   * * * * *   * * *   * * *   * * *   * * *   *   * * * * *   *   *   * 
*       *               *       *       *       *       *               *       *       *       *   * 
*   * * *   * * * * * * *   *   *   *   * * *   * * *   * * * * * * *   * * * * *   *   * * *   *   * 
*   *           *           *   *   *       *       *   *       *       *           *       *   *   * 
*   *   * * * * *   * * * * *   *   * * *   * * *   *   *   *   * * *   *   * * * * * * *   *   *   * 
*   *   *       *   *   *       *       *           *       *       *   *       *           *   *   * 
*   *   *   *   *   *   *   * * *   * * * * * * *   * * * * * * *   * * * * *   *   * * * * *   *   * 
*       *   *   *   *           *   *           *   *               *           *       *   *   *   * 
* * * * *   *   *   * * * * * * *   *   * * *   * * *   * * * * * * *   * * * * * * *   *   *   *   * 
*           *   *   *               *   *   *       *   *               *           *   *       *   * 
*   * * * * *   *   *   * * * * * * *   *   * * *   *   *   * * * * * * * * *   * * *   *   * * *   * 
*   *       *       *       *   *       *       *   *   *   *                   *       *   *       * 
*   *   *   * * * * * * *   *   *   * * *   *   *   *   *   * * *   * * * * *   *   * * *   * * *   * 
*       *       *       *   *   *   *       *   *   *   *   *       *       *   *   *       *       * 
*   * * * * *   *   *   *   *   * * *   * * *   *   *   *   *   *   *   *   * * *   *   * * *   * * * 
*           *   *   *       *       *       *       *           *   *   *           *       *       * 
* * * * *   *   *   * * * * *   *   * * *   * * * * * * *   * * * * *   * * * * * * * * *   * * *   * 
*           *       *           *               *       *   *       *       *           *       *   * 
*   * * * * * * * * *   * * *   * * * * * * *   *   *   * * *   *   * * *   *   * * * * * * *   *   * 
*   *   *               *           *   *           *           *           *   *           *       * 
* * *   *   *   *   * * * * * * *   *   *   * * * * * * * * * * * * * * * * *   *   * * *   * * *   * 
*       * * *   *   *       *   *   * * *   *                       *           *       *           * 
*   * * *   *   * * *   * * *   *       * * *   * * * * *   * * *   * * *   * * * * *   * * * * * * * 
*   *       *       *   *           *   *   *       * E     *           *           *       *       * 
*   *   * * * * *   *   * * * * *   *   *   * * *   *   * * * * * * *   * * *   *   * * *   *   *   * 
*                   *           *   * * *       *   *               *       *   *       *       *   * 
* * * * * * * * * * * * * * *   * * *   *   * * *   * * * * * * *   * * *   * * * * *   * * * * *   * 
*                   *           *                       *       *       *                   *       * 
*   * * * * * * *   *   * * * * *   * * *   * * * * * * *   *   * * *   * * * * * * * * *   *   * * * 
*           * E *       *           *   *   *       *       *           *           *       *       * 
* * * * *   *   * * * * * * *   *   *   *   *   *   *   * * * * * * * * *   * * *   *   * * * * *   * 
*       *   *               *   *   *       *   *   *   *               *       *   *           *   * 
* * *   *   * * *   * * *   * * *   *   * * *   * * *   *   * * * * *   * * *   *   * * * * *   *   * 
*       *   *       *   *       *   *   *           *       *   *       *       *   *           *   * 
*   * * *   *   * * *   * * *   * * *   *   * * *   * * * * *   *   * * *   * * *   * * *   * * *   * 
*   *       *   *               *       *       *       *       *       *   *   *       *   *       * 
*   *   * * *   *   *   * * * * *   * * * * * * *   *   * * *   * * *   *   *   * * *   * * *   * * * 
*   *           *   *               *           *   *       *       *   *       *       *       *   * 
*   * * * * * * *   * * * * * * * * * * *   *   *   * * *   * * *   *   * * *   *   * * *   * * *   * 
*                                           *       *               *           *                   * 
* * * * * * * * * * * * * * * * * * * * * * * * * * * * * * * * * * * * * * * * * * * * * * * * * * * 