
* * * * * * * * * * * * * * * * * * * * * * * * * * * * * * * * * * * * * * * * * * * * * * * * * * * 
* S                 *       *   *       *       *       *                       *                 E * 
* * * * *   * * *   *   *   *   *   *   *   * * *   * * *   * * * * * * *   *   * * * * *   * * *   * 
*           *   *   *   *       *   *       *           *   *   *           *               *       * 
*   * * * * *   *   *   * * * * *   *   * * * * * * *   *   *   *   * * * * * * * * * * * * *   * * * 
*   *       *   *   *       *       *               *       *   *           *               *       * 
*   *   *   *   *   * * *   *   * * * * * * *   *   * * * * *   * * * * *   *   * * * * *   * * *   * 
*       *   *               *               *   *                   *       *   *       *   *   *   * 
* * * * *   * * * * * * * * * * * * * * *   *   *   * * * * * * * * *   *   *   *   * * *   *   *   * 
*           *               *           *   *   *       *               *   *       *       *       * 
*   *   * * *   * * * * *   *   *   *   *   * * *   *   *   *   * * * * *   * * *   *   * * * * * * * 
*   *   *       *       *   *   *   *   *       *   *       *       *       *       *               * 
*   * * *   * * * * *   *   *   * * *   * * *   *   * * * * *   *   * * * * *   * * * * * * * * *   * 
*   *       *           *           *   *           *           *               *   *               * 
*   *   * * *   *   * * * * * * *   *   *   * * * * *   * * *   * * *   * * * * *   *   * * * * * * * 
*       *       *   *       *       *           *       *       *   *           *   *               * 
*   * * *   *   *   *   *   *   *   * * * * *   *   * * *   * * *   * * * * *   *   * * * * *   *   * 
*   *       *   *   *   *       *   *       *   *   *       *           *       *       *   *   *   * 
*   * * * * *   *   *   * * *   * * *   *   *   *   * * * * *   * * * * *   * * *   *   *   * * *   * 
*       *       *   *       *           *           *       *           *   *       *   *   *       * 
* * *   *   * * * * * * * * * * * * * * * * * * * * *   *   * * * * *   *   *   * * *   *   *   * * * 
*   *   *                   *               *           *               *   *   *   *   *       *   * 
*   *   *   * * * * *   *   * * * * * * *   *   * * * * *   * * * * * * *   *   *   *   * * * * *   * 
*       *           *   *                   *       *   *   *           *       *       *   *       * 
*   *   * * * * *   *   * * *   * * * * * * * * *   *   *   *   * * *   * * * * *   * * *   *   *   * 
*   *   *           *       *                       *   *   *   *   *       *       *   *       *   * 
* * *   * * * * * * * * *   * * *   * * * * * * * * *   *   *   *   *   * * *   * * *   *   * * *   * 
*   *       *           *               *                   *       *           *   *           *   * 
*   * * *   *   * * * * *   * * * * *   * * *   *   * * *   * * *   * * * * * * *   *   * * * * *   * 
*           *   *       *   *           *       *       *       *   *           *       *       *   * 
*   * * * * *   *   *   *   *   * * *   *   * * * * *   *   * * *   *   *   *   * * *   *   *   *   * 
*   *           *   *       *   *       *   *   *           *       *   *   *       *   *   *   *   * 
*   *   * * * * * * * * *   *   * * * * *   *   * * * * *   *   * * *   *   * * *   *   *   *   *   * 
*   *       *           *   *       *       *   *       *       *       *   *   *   *   *   *   *   * 
*   * * *   *   * * *   *   * * *   *   * * *   *   *   * * * * * * * * *   *   *   * * *   *   *   * 
*           *       *   *   *       *       *       *           *           *   *           *       * 
* * * * *   * * *   *   * * *   * * * * *   *   * * * * *   *   *   * * * * *   * * * * * * * * *   * 
*           *       *           *           *   *           *       *                   *   *       * 
*   * * * * *   * * * * * * * * *   * * * * * * *   * * * * * * * * *   * * * * *   *   *   *   * * * 
*           *       *               *               *                   *           *       *   *   * 
* * * * *   * * *   *   * * * * * * *   *   * * * * * * *   * * * * * * *   * * *   * * * * *   *   * 
*               *   *           *       *   *           *       *           *       *           *   * 
* * * * * * *   *   * * * * *   *   *   * * *   * * *   *   * * *   *   * * * * * * *   * * * * *   * 
*           *   *           *   *   *               *   *   *       *   *           *       *       * 
*   * * *   * * *   * * *   *   *   * * * * * * * * *   *   *   *   * * *   * * *   * * *   * * *   * 
*   *               *       *   *       *           *   *   *   *   *       *   *       *           * 
*   *   * * * * * * * * * * *   * * *   *   * * *   *   *   *   * * *   * * *   *   * * * * * * *   * 
*   *   *       *           *   *       *   *   *       *   *       *           *   *           *   * 
*   * * *   *   *   * * *   *   * * * * *   *   * * * * *   * * *   * * * * *   *   *   *   * * *   * 
* E         *           *                   *                   *               *       *         E * 
* * * * * * * * * * * * * * * * * * * * * * * * * * * * * * * * * * * * * * * * * * * * * * * * * * * 