
* * * * * * * * * * * * * * * * * * * * * * * * * * * * * * * * * * * * * * * * * * * * * * * * * * * 
* S *           *                             *         *   *           *               *         E * 
*   *   *   *   * * *   *   * * *   * *   * * * *   *   *   *   *   * * *   * * *   *   * * * * *   * 
*   *   *   *           *   *   *   *               *   *       *               *   *               * 
*       *   *   * * *   *   *   * * *   * * * * * * *   * * * * * * * * * * * * *   * * * * * * *   * 
* * *   *   *   *       *   *       *           *   *   *       *           *       *           *   * 
*   * * * * * * *   * * *   * * *   * * * * *   *   *   *   *   *   * * *   *   * * *   *   * * *   * 
*       *           *   *   *               *   *           *       *   *       *       *   *       * 
*   *   *   * * * * *   *   * * * * * *   * *   * * * * * * * * * * *   * * * * *   *   *   *   * * * 
*   *   *   *           *           *           *       *       *           *       *   *   *   *   * 
* * *   *   *   *   *   * * * * *   * * * * * * *   *   * * *   *   * * *   *   * * *   * * *   *   * 
*           *   *   *           *       *           *       *   *       *   *   *   *   *       *   * 
*   * * * * * * *   * * * * * * *   * * *   *   * * * * *   *   *   * * *   *   *   *   *   * * *   * 
*   *               *           *       *   *       *       *       *       *   *   *       *       * 
*   * * *   * * *   *   * * *   * * *       * * *   *   * * *   * * *   * * *   *   * * * * *   *   * 
*       *   *       *   *           *   * * *       *   *       *   *           *           *   *   * 
* * *   *   *   * * *   * * * * *   *   *   *   * * * * *   * * *   * * * * * * *   * * *   *   *   * 
*   *       *   *   *       *   *   *       *   *               *   *               *   *   *   *   * 
*   * * * * *   *   * * *   *       * * * * *   *   *   *   *   *   * * *   * * * * *   *   *   *   * 
* * *           *       *   * * *   *       *       *   *   *               *       *   *   *   *   * 
*       * * * * * * *   *   *   *   *   *   * * * * *   * * *   * * * * * * *   *   *   *   *   *   * 
*   *   *               *   *       *   *   *               *   *               *   *           *   * 
* * *   *   * * * * *   *   * * *   *   *   *   *   *   *   * * *   * * * * * * *   * * * * * * *   * 
*       *       *       *       *       *       *   *   *   *       *           *       *       *   * 
*   *   * * *   *   * * * * *   * * * * * * * * *   *   *   *   * * * * * * *   * * *   *   * * *   * 
*   * * *       *           *       *       *       * * *       *               *   *   *           * 
*   *   *   * * * * * * * * * * *   *   *   *   * * *   * * * * *   * * * * *   *   *   * * *   * * * 
*           *               *       *   *       *               *   *               *       *   *   * 
*   * * *   *   * * * * *   * * * * *   * * * * * * * * * * *   *   * * * * * * *   * * *   *   *   * 
*       *   *       *       *       *   *           *   *           *           *       *   *   *   * 
*   *   *   * * *   *   * * *   *   *   *   * * *   *   *   * * * * *   * * *   * * * * *   *   *   * 
*   *   *   *       *           *       *       *   *   *   *   *       *   *           *   *       * 
*   * * *   *   *   * * * * *   * * * * * * *   *   *   *   *   *   * * *   * * * * *   *   * * *   * 
*           *   *   *       *       *           *   *           *   *               *       *       * 
*   * * * * *   * * *   *   * * *   *   * * * * *   * * * * *   *   *   * * *   *   * * * * *   * * * 
*           *       *   *       *       *       *       *       *   *       *   *   *   *       *   * 
*   * * * * * * *   *   * * *   * * * * *   * * * * *   *   * * *   *   * * *   *   *   *   * * *   * 
*   *       *       *       *   *       *               *   *       *   *       *   *   *           * 
* * *   *   * * *   * * *   *   * * *   *   * * * * * * *   *   * * * * *   * * *   *   * * * * *   * 
*       *               *   *           *   *       *   *   *           *       *               *   * 
*   * * * * *   * * * * *   * * * * * * *   *   *   *   *   * * * * *   *   *   * * * * * * *   *   * 
*   *           *           *           *       *   *           *       *   *   *       *       *   * 
*   *   *   * * *   * * * * *   *   * * * * * * *   * * * * * * *   * * * * *   * * *   *   * * *   * 
*   *   *       *           *   *               *               *           *       *           *   * 
*   *   *   *   * * * * *   * * * * *   *   * * * * * * * * *   * * * * *   *   *   * * * * *   *   * 
*       *   *           *   *       *   *           *           *           *   *           *   *   * 
*   * * *   *   * * * * *   *   *   *   * * * * *   *   * * * * *   * * * * *   * * * * *   * * *   * 
*       *   *     *     *       *   *   *       *       *           *           *       *       *   * 
* * *   * * * *   * *   * * * * *   *   *   *   *   *   * * * * *   *   * * * * * * *   * * *   *   * 
* E                 *               *       *       *               *                       *     E * 
* * * * * * * * * * * * * * * * * * * * * * * * * * * * * * * * * * * * * * * * * * * * * * * * * * * 