
* * * * * * * * * * * * * * * * * * * * * * * * * * * * * * * * * * * * * * * * * * * * * * * * * * * 
* S             *       *           *                               *               *       *     E * 
*   * * * * *   *   * * *   *   *   * * *   * * * * * * * * * * *   *   * * * * *   *   *   * * *   * 
*       *           *       *   *       *   *                   *   *   *       *       *           * 
*   *   * * * * * * *   * * *   * * *   *   *   * * * * * * *   *   *   *   * * * * * * * * * * *   * 
*   *       *       *       *       *       *       *   *       *       *               *           * 
*   * * * * *   *   * * *   * * *   * * * * * * *   *   *   * * * * * * *   * * *   * * *   * * * * * 
*       *       *       *   *       *           *       *       *       *   *   *           *       * 
* * *   *   * * * * *   * * *   *   *   * * *   * * *   * * *   * * *   *   *   * * * * * * *   *   * 
*               *   *       *   *   *   *   *       *   *   *       *   *       *           *   *   * 
* * * * *   *   *   * * *       * * *   *   * * *   *   *   * * *   *   * * *   * * *   *   * * *   * 
*       *   *               *               *       *       *       *                   *           * 
*   *   *   * * * * *   * * * * *   * * * * *   * * * * *   *   * * *   * * * * * *   * * * * * *   * 
*   *   *   *           *       *   *       *           *   *       *           *       *       *   * 
*   * * *   *   * * * * *   *   * * *   *   *   * * *   *   * * *   * * * * * * *   *   *   *   * * * 
*   *       *         *     *       *   *   *       *           *   *               *       *       * 
*   * * * * * * *   * *   * * * *   * * *   * * * * *   * * * * *   *   * * * * * * * * * * * * *   * 
*           *               *       *   *   *       *   *       *           *               *       * 
* * *   * * *   * * * * *   *   * * *   *   *   *   * * *   *   * * * * *   * * *   * * *   *   * * * 
*   *   *       *       *       *       *       *           *   *       *   *       *   *   *       * 
*   *   * * * * * * *   * * * * *   *   * * * * * * * * * * *   *   *   *   *   * * *   *   * * *   * 
*   *   *       *               *   *       *           *       *   *   *   *       *   *   *       * 
*   *   *   *   *   * * * * *   * * *   *   * * *   * * *   * * *   *   *   * * *   *   *   *   * * * 
*   *   *   *       *       *       *   *       *       *           *   *       *   *       *       * 
*   *   *   * * * * *   * * * * *   *   * * *   * * *   * * *   * * *   * * *   *   *   * * * * *   * 
*   *       *       *           *   *   *       *   *       *       *       *       *       *       * 
*   * * * * *   * * *   * * *   *   * * *   * * *   * * *   * * *   * * *   * * * * * * * * * * *   * 
*   *               *       *   *           *           *           *   *       *           *       * 
*   *   * * * * *   * * *   *   * * * * * * * * *   * * * * * * * * *   * * *   *   *   * * *   *   * 
*           *       *       *       *   *       *   *                   *           *       *   *   * 
* * * * * * *   * * *   * * *   *   *   * * *   *   *   * * * * * * *   *   * * *   * * *   *   *   * 
*           *   *       *       *               *   *   *       *       *       *   *           *   * 
*   * * *   *   *   * * *   * * *   * * * * * * *   *   *   *   *   * * * * *   *   *   * * * * *   * 
*       *   *   *   *   *       *   *       *       *       *   *           *   *   *   *   *       * 
* * *   *   *   *   *   * * *   *   *   *   *   *   * * * * *   * * *   * * *   *   *   *   *   * * * 
*       *       *       *       *       *   *   *       *   *       *           *   *       *       * 
*   * * * * * * *   * * *   * * * * * * *   *   *   *   *   * * *   * * * * * * *   * * *   * * *   * 
*       *           *       *           *   *   *   *   *       *   *       *   *   *   *       *   * 
*   *   *   * * * * *   * * *   * * *   *   * * *   *   * * *   *   *   *   *   *   *   *   * * *   * 
*   *               *   *       *   *   *           *           *       *       *   *       *       * 
*   * * * * * * * * *   *   * * *   *   * * * *   * * * *   * * * * * * * * *   *   * * * * *   * * * 
*   *       *           *           *       *       *       *       *           *           *       * 
*   * * *   *   * * * * * * * * *   * * *   *   *   *   * * *   *   *   * * * * * * * * *   * * *   * 
*           *               *           *       *   *       *   *       *   *       *       *       * 
* * * * *   * * * * * * *   * * * * * * * * * * *   *   * * *   * * * * *   *   *   *   *   *   * * * 
*       *   *           *       *               *       *       *           *   *       *   *       * 
*   * * *   *   * * *   * * *   *   * * * * *   * * * * *   * * * * *   * * *   * * * * * * * * *   * 
*       *       *   *   *       *       *   *   *                   *       *   *   *       *       * 
*   *   * * * * *   *   *   * * * * *   *   *   *   * * * * *   *   * * *   *   *   *   *   *   * * * 
* E *                   *                   *               *   *                       *         E * 
* * * * * * * * * * * * * * * * * * * * * * * * * * * * * * * * * * * * * * * * * * * * * * * * * * * 