
* * * * * * * * * * * * * * * * * * * * * * * * * * * * * * * * * * * * * * * * * * * * * * * * * * * 
* E     *       *       *                                   *           *       *       *         E * 
*   *   *   *   *   *   *   *   * * * * * * * * * * * * *   *   *   *   *   *   * * *   *   * * *   * 
*   *       *       *       *       *       *               *   *   *       *   *       *   *       * 
*   * * * * * * * * *   * * * * *   *   * * *   * * * * * * *   *   * * * * *   *   * * *   *   *   * 
*   *       *       *           *   *       *   *               *   *       *   *   *       *   *   * 
*   *   * * *   *   * * * * *   *   * * *   *   *   * * * * * * *   * * *   *   *   *   * * *   *   * 
*   *       *   *           *   *       *       *   *           *       *   *       *       *   *   * 
*   *   *   *   * * * * *   * * * * *   *   * * * * *   * * *   * * *   *   * * *   * * *   *   * * * 
*   *   *   *   *               *       *               *       *       *   *           *   *       * 
*   * * *   *   * * * * * * *   *   * * * * * * * * * * *   * * *   * * *   *   * * * * *   * * *   * 
*   *       *               *   *   *                   *   *       *               *       *   *   * 
*   *   * * * * * * * * *   *   *   *   * * * * * * *   *   *   * * * * * * * * * * *   * * *   *   * 
*   *                   *   *       *   *           *           *       *               *       *   * 
*   *   * * *   * * *   *   * * * * *   *   * * *   * * * * * * *   *   *   * * * * * * *   * * *   * 
*   *   *   *       *   *           *   *   *               *       *       *               *       * 
*   *   *   * * *   *   * * * * *   *   *   * * * * *   * * *   * * * * * * * * *   * * *   *   * * * 
*   *           *   *   *       *   *   *       *       *       *                   *   *   *       * 
*   * * * * * * *   *   * * *   *   *   * * *   * * * * *   * * *   * * * * * * * * *   *   * * *   * 
*                   *           *   *       *           *       *       *           *       *   *   * 
* * * * * * * * * * * * * * * * *   * * *   * * * * *   * * *   * * *   *   * * *   *   * * *   *   * 
*                                   *   *       *       *   *           *   *       *   *       * S * 
*   * * *   * * * * * * * * * * * * *   * * *   *   *   *   * * * * * * *   * * * * *   *   *   * * * 
*   *       *       *           *           *       *           *       *               *   *       * 
*   * * * * *   *   *   * * *   *   * * *   *   * * * * * * *   * * *   *   * * * * * * *   * * *   * 
*   *           *   *   *       *   *       *   *           *           *   *       *           *   * 
*   *   * * * * *   *   *   * * * * *   * * *   *   * * *   * * * * *   *   * * *   *   * * *   *   * 
*   *           *       *           *           *       *           *   *   *       *       *   *   * 
*   * * * * *   * * * * *   * * *   * * * * *   * * *   * * * * *   *   *   *   * * * * *   *   *   * 
*           *   *       *   *       *       *       *           *   *   *   *               *   *   * 
*   * * *   *   *   *   * * *   * * *   *   * * * * *   * * * * *   *   *   * * * * * * *   *   * * * 
*   *   *       *   *           *       *           *   *           *   *   *           *   *       * 
*   *   * * * * *   * * *   * * *   * * * * * * *   *   *   * * * * * * *   *   * * *   *   * * *   * 
*   *           *       *   *       *               *   *                   *       *   *   *       * 
*   * * * * *   * * *   * * *   * * *   * * * * * * *   * * * * * * * * * * * * *   *   * * *   * * * 
*       *       *       *       *   *               *       *       *           *   *       *       * 
* * *   *   *   *   * * *   * * *   * * * * * * *   * * *   *   *   *   *   *   *   * * *   *   *   * 
*   *       *   *       *   *                   *       *   *   *   *   *   *       *   *   *   *   * 
*   * * * * *   * * *   *   * * * * *   * * * * * * *   *   *   *   * * *   * * * * *   *   *   *   * 
*               *       *   *       *               *       *   *           *           *   *   *   * 
*   * * * * * * *   *   *   *   *   * * * * * * *   * * * * *   * * * * * * *   *   * * *   * * *   * 
*       *           *   *       *           *       *       *   *   *           *   *       *       * 
*   * * *   * * * * *   * * * * * * * * *   *   *   *   *   *   *   *   * * *   * * *   * * *   * * * 
*   *       *           *           *       *   *       *       *       *   *       *   *           * 
* * *   * * * * * * * * *   *   *   *   * * *   * * * * * * * * *   * * *   * * *   *   * * * * *   * 
*       *                   *   *   *   *       *       *       *       *       *   *   *       *   * 
*   * * *   * * * * * * * * *   *   *   *   *   *   *   * * *   * * *   * * *   *   *   *   *   *   * 
*           *       *   *       *   *   *   *       *       *       *       *   *       *   *       * 
*   * * * * *   *   *   *   * * * * *   * * * * * * * * *   *   *   * * *   *   * * * * *   * * *   * 
* E             *       *                                   *   *                           *       * 
* * * * * * * * * * * * * * * * * * * * * * * * * * * * * * * * * * * * * * * * * * * * * * * * * * * 