
* * * * * * * * * * * * * * * * * * * * * * * * * * * * * * * * * * * * * * * * * * * * * * * * * * * 
* E *                               *           *           *       *           *       *         E * 
*   *   * * * * * * *   * * * * *   *   *   * * *   *   *   *   *   *   *   *   *   *   * * *   *   * 
*   *   *           *           *   *   *   *       *   *       *   *   *   *       *       *   *   * 
*   *   *   *   *   * * * * *   *   * * *   *   * * *   * * * * *   * * *   * * * * * * *   *   * * * 
*       *   *   *           *   *           *   *       *       *           *           *   *       * 
*   * * * * *   * * * * * * *   * * * * *   *   *   * * * * *   * * * * * * *   *   *   *   * * *   * 
*               *               *   *       *   *       *                   *   *   *   *       *   * 
* * * * * * *   *   * * * * * * *   *   * * *   * * *   *   *   * * * * * * *   *   * * * * *   *   * 
*           *   *               *       *       *       *   *   *           *   *           *   *   * 
* * *   * * *   * * * * * * *   * * * * *   * * *   * * *   * * *   * * *   *   * * * * *   *   *   * 
*       *               *       *       *       *       *               *       *       *       *   * 
*   * * *   * * * * * * *   *   *   *   * * *   * * *   * * * * * * *   * * * * *   *   * * *   *   * 
*   *           *           *   *   *       *       *   *       *       *           *       *   *   * 
*   *   * * * * *   * * * * *   *   * * *   * * *   *   *   *   * * *   *   * * * * * * *   *   *   * 
*   *   *       *   *   *       *       *           *       *       *   *       *           *   *   * 
*   *   *   *   *   *   *   * * *   * * * * * * *   * * * * * * *   * * * * *   *   * * * * *   *   * 
*       *   *   *   *           *   *           *   *               *           *     E *   *   *   * 
* * * * *   *   *   * * * * * * *   *   * * *   * * *   * * * * * * *   * * * * * * *   *   *   *   * 
*           *   *   *               *   *   *       *   *               *           *   *       *   * 
*   * * * * *   *   *   * * * * * * *   *   * * *   *   *   * * * * * * * * *   * * *   *   * * *   * 
*   *       *       *       *   *       *       *   *   *   *                   *       *   *       * 
*   *   *   * * * * * * *   *   *   * * *   *   *   *   *   * * *   * * * * *   *   * * *   * * *   * 
*       *       *       *   *   *   *       *   *   *   *   *       *       *   *   *       *       * 
*   * * * * *   *   *   *   *   *   *   * * *   *   *   *   *   *   *   *   * * *   *   * * *   * * * 
*           *   *   *       *   *   *       *       *           *   *   *           *       *       * 
* * * * *   *   *   * * * * *   *   * * *   * * * * * * *   * * * * *   * * * * * * * * *   * * *   * 
*       *   *       *           *       *       *       *   *       *       *           *       *   * 
*   *   *   * * * * *   * * *   * * *   * * *   *   *   * * *   *   * * *   *   * * * * * * *   *   * 
*   *   *   *           *           *   *   *       *           *           *   *           *       * 
* * *   *   *   *   * * * * * * *   *   *   * * * * * * * * * * * * * * * * *   *   * * *   * * *   * 
*       *   *   *   *     S *   *   *   *   *                       *           *       *           * 
*   * * *   *   * * *   * * *   *   *   *   *   * * * * *   * * *   * * *   * * * * *   * * * * * * * 
*   *       *       *   *           *   *   *       *       *           *           *       *       * 
*   *   * * * * *   *   * * * * *   *   *   * * *   *   * * * * * * *   * * *   *   * * *   *   *   * 
*                   *           *   *   *       *   *               *       *   *       *       *   * 
* * * * * * * * * * * * * * *   * * *   *   * * *   * * * * * * *   * * *   * * * * *   * * * * *   * 
*                   *           *       *               *       *       *                   *       * 
*   * * * * * * *   *   * * * * *   * * *   * * * * * * *   *   * * *   * * * * * * * * *   *   * * * 
*           *   *       *           *   *   *       *       *           *           *       *       * 
* * * * *   *   * * * * * * *   *   *   *   *   *   *   * * * * * * * * *   * * *   *   * * * * *   * 
*       *   *               *   *   *       *   *   *   *               *       *   *           *   * 
* * *   *   * * *   * * *   * * *   *   * * *   * * *   *   * * * * *   * * *   *   * * * * *   *   * 
*       *   *       *   *           *   *           *       *   *       *       *   *           *   * 
*   * * *   *   * * *   * * * * * * *   *   * * *   * * * * *   *   * * *   * * *   * * *   * * *   * 
*   *       *   *               *       *       *       *       *       *   *   *       *   *       * 
*   *   * * *   *   *   * * * * *   * * * * * * *   *   * * *   * * *   *   *   * * *   * * *   * * * 
*   *           *   *               *           *   *       *       *   *       *       *       *   * 
*   * * * * * * *   * * * * * * * * * * *   *   *   * * *   * * *   *   * * *   *   * * *   * * *   * 
*                                           *       *               *           *                   * 
* * * * * * * * * * * * * * * * * * * * * * * * * * * * * * * * * * * * * * * * * * * * * * * * * * * 