
* * * * * * * * * * * * * * * * * * * * * * * * * * * * * * * * * * * * * * * * * * * * * * * * * * * 
*               *       *           *                               *               *       *     E * 
*   * * * * *   *   * * *   *   *   * * *   * * * * * * * * * * *   *   * * * * *   *   *   * * *   * 
*       *           *       *   *       *   *                   *   *   *       *       *           * 
*   *   * * * * * * *   * * *   * * *   *   *   * * * * * * *   *   *   *   * * * * * * * * * * *   * 
*   *                       *       *       *       *   *       *       *               *           * 
*   * * * * * * * * * * *   * * *   * * * * * * *   *   *   * * * * * * *   * * *   * * *   * * * * * 
*       *               *   *       *           *       *       *       *   *   *           *       * 
* * *   *   * * * * *   * * *   *   *   * * *   * * *   * * *   * * *   *   *   * * * * * * *   *   * 
*       *   *       *       *   *   *   *   *       *   *   *       *   *       *           *   *   * 
* * * * *   *   *   * * *   *   * * *   *   * * *   *   *   * * *   *   * * *   * * *   *   * * *   * 
*       *   *   *           *               *       *       *       *                   *           * 
*   *   *   *   * * *   * * * * *   * * * * *   * * * * *   *   * * *   * * * * * * * * * * * * *   * 
*   *   *   *   *       *       *   *       *           *   *       *           *       *       *   * 
*   *   *   *   * * * * *   *   * * *   *   *   * * *   *   * * *   * * * * * * *   *   *   *   * * * 
*   *       *               *       *   *   *       *           *   *               *       *       * 
*   * * * * * * * * * * * * * * *   *   *   * * * * *   * * * * *   *   * * * * * * * * * * * * *   * 
*           *               *       *   *   *       *   *       *           *               *       * 
* * *   * * *   * * * * *   *   * * *   *   *   *   * * *   *   * * * * *   * * *   * * *   *   * * * 
*   *   * S     *       *       *       *       *           *   *       *   *       *   *   *       * 
*   *   * * * * * * *   * * * * *   *   * * * * * * * * * * *   *   *   *   *   * * *   *   * * *   * 
*   *   *       *               *   *       *                   *   *   *   *       *   *   *       * 
*   *   *   *   *   * * * * *   * * *   *   * * *   * * * * * * *   *   *   * * *   *   *   *   * * * 
*   *   *   *       *       *       *   *       *       *           *   *       *   *       *       * 
*   *   *   * * * * *   * * * * *   *   * * *   * * *   * * *   * * *   * * *   *   *   * * * * *   * 
*   *       *       *           *   *   *       *   *       *       *       *       *       *       * 
*   * * * * *   * * *   * * *   *   * * *   * * *   * * *   * * *   * * *   * * * * * * * * *   *   * 
*   *               *       *   *           *           *           *   *                       *   * 
*   *   * * * * *   * * *   *   * * * * * * * * *   * * * * * * * * *   * * * * * * * * * * * * *   * 
*           *       *       *                   *   *                   *                   *   *   * 
* * * * * * *   * * *   * * *   * * * * * * *   *   *   * * * * * * *   *   * * *   * * *   *   *   * 
*           *   *       *       *               *   *   *       *       *       *   *           *   * 
*   * * *   *   *   * * *   * * *   * * * * * * *   *   *   *   *   * * * * *   *   *   * * * * *   * 
*       *   *   *   *   *       *   *       *       *       *   *           *   *   *   *   *       * 
* * *   *   *   *   *   * * *   *   *   *   *   *   * * * * *   * * *   * * *   *   *   *   *   * * * 
*       *       *       *       *       *   *   *       *   *       *           *   *       *       * 
*   * * * * * * *   * * *   * * * * * * *   *   *   *   *   * * *   * * * * * * *   * * *   * * *   * 
*       *           *       *           *   *   *   *   *       *   *       *   *   *   *       *   * 
*   *   *   * * * * *   * * *   * * *   *   * * *   *   * * *   *   *   *   *   *   *   *   * * *   * 
*   *               *   *       *   *   *           *           *       *       *   *       *       * 
*   * * * * * * * * *   *   * * *   *   * * * * * * * * *   * * * * * * * * *   *   * * * * *   * * * 
*   *       *           *           *       *       *       *       *           *           *       * 
*   * * *   *   * * * * * * * * *   * * *   *   *   *   * * *   *   *   * * * * * * * * *   * * *   * 
*           *               *           *       *   *       *   *       *   *       *       *       * 
* * * * *   * * * * * * *   * * * * * * * * * * *   *   * * *   * * * * *   *   *   *   *   *   * * * 
*       *   *           *       *               *       *       *           *   *       *   *       * 
*   * * *   *   * * *   * * *   *   * * * * *   * * * * *   * * * * *   * * *   * * * * * * * * *   * 
*       *       *   *   *       *       *   *   *           *       *       *                     E * 
*   *   * * * * *   *   *   * * * * *   *   *   *   * * * * *   *   * * *   * * * * * * * * * * * * * 
* E *                   *                   *                   *                                   * 
* * * * * * * * * * * * * * * * * * * * * * * * * * * * * * * * * * * * * * * * * * * * * * * * * * * 