
* * * * * * * * * * * * * * * * * * * * * * * * * * * * * * * * * * * * * * * * * * * * * * * * * * * 
* S     *           *               *               *   *           *               *           * E * 
* * *   *   * * *   *   *   * * *   *   *   * * *   *   *   *   *   * * * * *   *   * * *   *   *   * 
*       *   *       *   *       *   *   *   *   *   *       *   *           *   *           *   *   * 
*   *   *   *   * * *   * * *   *   * * *   *   *   *   * * *   * * * * *   *   * * * * * * *   *   * 
*   *   *   *               *   *       *   *       *       *   *       *   *       *           *   * 
*   * * *   * * * * * * * * *   * * *   *   *   * * * * * * *   *   * * *   * * *   *   * * * * *   * 
*       *   *       *           *   *       *   *               *       *   *       *   *           * 
*   *   *   *   * * *   * * * * *   * * * * *   *   * * * * * * *   *   *   *   * * *   *   * * *   * 
* * *   *       *       *       *               *               *   *       *   *           *       * 
*       * * *   *   * * *   *   * * * * *   * * * * * * * * *   * * *   * * *   * * * * * * * * * * * 
*   *           *       *   *   *       *       *               *                       *           * 
*   * * * * * * * * *   *   *   *   *   * * *   * *   * *   * * *   *   * * * * * * *   * * * * *   * 
*   *           *   *       *       *   *   *           *       *   *               *       *      * 
*   * * *   *   *   * * * * * * * * *   *   *   * * *   * * * * *   * * * * * * * * * * *   *   *   * 
*       *   *           *               *       *   *       *       *                   *       * * * 
* * *   *   * * * * * * *   * * * * * * *   * * *   * * *   *   * * *   * * * * * * *   *   *   *   * 
*   *       *       *       *       *       *       *       *       *       *       *       *   *   * 
*   * * *   *   *   *   * * *   * * *   * * * * *   *   * * * * *   *   *   * * *   * * * * *       * 
*           *   *   *       *       *   *           *               *   *   *       *       * * *   * 
* * * * * * *   *   * * *   * * *   *   * * *   * * * * *   * * * * * * *   *   *   * * *   *       * 
*           *   *           *       *           *       *           *       *   *       *   *   *   * 
*   * * *   *   * * * * * * *   * * * * * * *   *   *   * * * *   * *   * * *   * * *   *   *   * * * 
*       *                       *       *       *   *                           *   *   *   *       * 
* * *   * * * * * * *   * * * * *   *   *   * * *   * * * * *   * * *   *   * * *   *   *   * * *   * 
*   *               *   *           *           *       *       *   *   *   *       *   *   *       * 
*   * * * * * * *   *   *   * * * * * * * * *   * * *   *   *   *   * * *   *   *   *   *   *   * * * 
*               *   *       *           *           *       *               *   *   *   *   *   *   * 
*   *   * * * * *   *   * * *   * * *   * * * * * * *   * * * * * * *   * * *   * * *   *   *       * 
*   *   *           *     E *       *       *               *                   *       *   *   *   * 
*   *   *   *   * * * * *   * * *   * * *   *   * * * * *   *   *   * * * * *   *   * * *   * * *   * 
*   * * *   *   *       *   *       *   *         E *       *   *       *                   *   *   * 
*       *   * * *   *   * * *   * * *   * * * * * * *   * * *   *   *   *   *   * * * * * * *   *   * 
*   *   *           *   *       *               *       *       *   *       *       *               * 
* * *   * * *   * * *   *   * * *   *   * * *   *   * * *   *   * * * * * * *   * * *   * * * * * * * 
*       *       *   *       *       *   *   *   *       *   *       *           *       *           * 
*   * * * * * * *   * * * * * * *   *   *   *   * * *   *   * * *   * * * * * * *   * * * * * * *   * 
*                   *           *   *   *       *       *       *   *           *   *               * 
*   * * *   * * *   *   * * *   * * *   *   * * *   * * * * * * *   *   * * *   *   * * *   * * *   * 
*   *       *       *       *           *       *           *       *       *   *           *   *   * 
*   *   * * *   * * * * *   *   * * * * * * * * * * * * *   *   * * * * *   *   * * * * * * *   *   * 
*   *   *   *               *   *           *           *   *               *       *           *   * 
* * *   *   * * * * * * * * *   *   * * *   *   *   * * * * * * * * * * * * *   *   *   * * * * *   * 
*       *                   *   *       *       *                       *       *       *           * 
*   * * * * * * * * *   *   *   * * *   * * * * * * * * *   * * * * *   *   * * * * * * *   * * * * * 
*   *               *   *       *       *       *           *       *       *           *           * 
*   *   * * * * *   *   * * * * *   * * *   * * *   * * * * *   * * *   * * *   * * *   * * * * *   * 
*   *       *   *   *           *       *       *   *       *           *       *   *           *   * 
*   * * *   *   *   * * * * * * * * *   * * *   *   *   *   * * * * * * *   * * *   *   * * * * *   * 
*               *                               *       *                           *               * 
* * * * * * * * * * * * * * * * * * * * * * * * * * * * * * * * * * * * * * * * * * * * * * * * * * * 