
* * * * * * * * * * * * * * * * * * * * * * * * * * * * * * * * * * * * * * * * * * * * * * * * * * *
* S     *                   *       *           *           *                   *       *         E *
*   *   * * * * *   * * *   *   *   *   * * * * *   * * *   *   * * * * *   *   *   *   *   * * *   *
*   *           *       *       *       *           *   *   *   *       *   *       *       *   *   *
*   * * * * *   * * *   * * *   * * * * *   * * * * *   *   *   *   *   *   * * * * * * * * *   *   *
* * *       *           *   *   *           *           *       *   *   *       *               *   *
*   *   *   * * * * * * *   *   *   * * * * *   * * *   * * * * *   *   * * *   * * * * *   *   *   *
*       *   *       *           *   *           *   *   *           *       *       *       *   *   *
*   * * *   *   *   *   * * * * *   *   * * * * *   *   *   * * *   * * *   * * *   *   * * *   *   *
*   *       *   *           *       *   *   *           *   *       *       *       *       *   *   *
* * *   *   *   * * * * * * *   * * *   *   *   * * * * *   *   * * *   * * *   * * *   *   *   *   *
*       *   *   *               *       *   *   *   *       *   *   *   *       *       *   *   *   *
*   *   * * *   *   * * * * * * * * *   *   *   *   *   * * *   *   *   *   * * * * * * *   * * *   *
*   *           *   *       *           *   *   *       *       *   *   *               *           *
*   *   * * * * *   *   *   *   * * * * *   *   * * *   *   * * *   *   * * * * * * *   * * * * * * *
*   *   *       *       *           *       *       *   *   *           *           *   *           *
*   * * *   *   * * * * * * *   *   *   *   * * *   * * *   *   * * * * * * *   *   *   *   * * *   *
*           *               *   *   *   *       *           *           *       *   *   *   *   *   *
*   * * * * * * * * *   *   *   *   * * *   *   * * * * * * * * * * *   *   * * * * *   *   *   *   *
*   *               *   *       *           *       *       *           *   *       *           *   *
*   * * *   * * *   *   *   * * * * * * * * * * *   * * *   *   * * * * *   *   *   * * * * * * *   *
*       *   *       *   *   *           *       *           *   *       *   *   *   *               *
* * *   * * *   * * *   * * *   * * *   * * *   * * * * * * *   *   *   *   *   *   *   * * * * *   *
*       *   *           *       *           *                   *   *       *   *       *       *   *
*   * * *   *   * * * * *   * * *   *   * * * * * * * * *   * * *   * * *   *   * * * * *   * * *   *
*   *       *               *       *   *       *       *           *       *       *       *       *
*   *   * * * * * * * * * * * * * * *   *   *   *   *   * * * * * * *   * * * * *   * * *   *   * * *
*   *       *                           *   *       *       *       *           *       *       *   *
* * * * *   * * *   * * * * * * *   * * *   * * * * * * *   *   *   * * * * * * * * *   * * *   *   *
*   *       *       *   *       *   *       *           *       *   *               *       *       *
*   *   * * *   * * *   *   * * * * *   * * * * * * *   * * * * *   *   * * * * *   *   *   * * * * *
*       *       *       *           *   *                   *   *   *       *       *   *           *
*   * * *   *   * * *   * * *   * * *   *   * * * * * * *   *   *   * * *   *   * * * * * * *   *   *
*       *   *       *           *       *   *       *           *       *   *               *   *   *
*   *   * * * * *   *   * * * * *   * * *   *   *   * * * * * * * * *   *   * * * * * * *   * * *   *
*   *               *       *       *       *   *                   *   *               *       *   *
*   * * *   * * * * *   *   *   * * *   *   *   * * * * * * * * *   *   *   * * * * *   * * *   *   *
*           *           *       *   *   *   *       *           *       *       *       *   *       *
*   * * * * *   * * * * * * * * *   *   *   * * *   * * *   *   * * * * * * * * *   * * *   * * *   *
*       *       *       *               *               *   *                   *       *           *
* * * * *   * * *   * * *   * * * * * * * * * * * * *   *   * * *   * * * * *   *   *   *   * * * * *
*           *   *           *       *           *   *   *   *       *   *       *   *   *           *
*   * * * * *   *   * * * * *   *   *   * * *   *   *   * * *   * * *   *   * * * * *   * * * * *   *
*       *   *       *       *   *   *       *   *   *       *   *       *               *       *   *
*   *   *   *   * * *   *   *   *   * * *   *   *   * * *   *   *   *   * * * * * * * * *   *   *   *
*   *   *   *   *       *       *           *   *       *   *   *   *   *           *       *       *
*   *   *   *   *   * * * * * * * * * * * * *   *   * * *   *   * * *   *   * * *   *   * * * * * * *
*   *   *       *   *         *         *   *   *               *   *       *   *       *           *
*   *   * * * * *   * * *   * *   * * * *   *   * * * * * * * * *   *   * * *   * * * * *   * * *   *
* E *                                       *                       *                       *     E *
* * * * * * * * * * * * * * * * * * * * * * * * * * * * * * * * * * * * * * * * * * * * * * * * * * *
