
* * * * * * * * * * * * * * * * * * * * * * * * * * * * * * * * * * * * * * * * * * * * * * * * * * * 
* S         *                                           *                       *                   * 
*   * * *   *   * * * * * * * * * * * * *   * * * * *   *   *   * * * * * * *   *   * * * * *   *   * 
*       *       *           *           *           *   *   *           *       *   *   *       *   * 
* * *   * * * * *   * * *   * * * * *   * * * * *   * * *   * * * * *   * * * * *   *   *   * * *   * 
*       *           *   *                   *       *       *       *       *       *   *   *       * 
*   * * *   * * *   *   * * * * * * *   * * *   *   *   * * *   *   * * *   *   * * *   *   * * * * * 
*   *       *       *   *           *   *       *   *   *   *   *       *   *           *   *       * 
*   *   * * *   * * *   *   *   * * *   *   * * * * *   *   *   * * *   *   * * * * *   *   *   *   * 
*   *   *   *       *       *           *   *       *   *   *   *   *   *               *       *   * 
*   *   *   * * *   *   * * * * *   * * *   *   *   *   *   *   *   *   * * * * * * * * * * * * *   * 
*   *       *       *   *       *       *   *   *       *   *   *   *       *                       * 
*   *   * * *   * * *   *   *   * * * * *   *   * * * * *   *   *   * * *   *   * * * * * * * * *   * 
*   *   *       *       *   *           *                   *   *   *       *       *       *       * 
*   * * *   *   * * * * *   * * * * *   * * * * * * * * *   *   *   *   * * * * *   *   * * *   * * * 
*       *   *   *           *       *       *       *       *   *   *       *       *   *       *   * 
* * *   *   *   *   * * * * *   *   * * *   * * *   *   * * *   *   * * *   *   * * *   *   * * *   * 
*   *       *   *   *           *   *   *       *       *       *   *       *       *   *   *       * 
*   *   * * * * *   *   * * *   *   *   * * *   *   * * *   * * *   *   * * * * *   *   *   * * *   * 
*   *   *           *   *   *   *           *   *       *   *               *       *   *       *   * 
*   *   *   * * * * *   *   *   * * * * * * *   * * * * *   * * * * * * *   *   * * *   * * *   *   * 
*       *   *           *   *                           *               *   *   *   *       *       * 
*   * * *   * * * * *   *   * * * * * * * * * * * * *   * * * * *   *   *   *   *   *   *   * * *   * 
*   *   *           *           *   *               *           *   *   *       *   *   *   *       * 
*   *   * * * * *   * * * * *   *   *   * * * * *   * * * * *   * * *   * * * * *   *   *   *   * * * 
*   *       *       *               *       *       *       *           *       *       *           * 
*   *   *   *   * * *   * * * * * * * * *   *   * * *   *   * * * * * * * * *   *   * * * * * * * * * 
*       *   *   *   *       *           *   *           *   *               *           *           * 
* * * * *   *   *   * * *   *   *   * * *   * * * * * * *   *   * * * * *   *   * * * * *   * * *   * 
*       *   *   *       *   *   *   *       *           *               *   *   *       *   *   *   * 
*   * * *   *   *   *   *   *   *   *   * * * * * * *   * * * * * * * * *   *   *   *   *   *   *   * 
*   *       *   *   *       *   *       *                       *           *   *   *           *   * 
*   *   * * *   * * * * * * *   * * * * *   * * * * * * * * *   *   * * * * *   *   * * * * * * *   * 
*           *   *               *           *   *           *   *           *   *   *       *     E * 
* * * * * * *   *   * * * * * * *   * * * * *   *   *   * * *   * * * * *   * * *   *   *   *   *   * 
*           *   *       *           *       *       *   *       *       *               *   *   *   * 
*   * * *   *   * * *   *   *   * * *   *   *   * * *   *   * * *   * * * * * * * * * * * * *   *   * 
*   *           *       *   *   *   *   *   *       *       *                   *               *   * 
*   * * * * *   *   * * * * *   *   *   *   * * *   * * * * *   * * *   * * * * *   * * * * * * *   * 
*       *       *   *           *   *   *       *   *               *   *           *           *   * 
*   *   * * * * *   *   * * * * *   *   *   * * *   * * * * * * * * *   *   *   * * * * * * *   *   * 
*   *       *       *   *               *   *       *                   *   *   *           *   *   * 
*   * * *   *   * * *   *   * * * * * * *   *   * * *   * * * * * * *   *   * * *   * * *   *   *   * 
*       *   *   *       *       *       *   *           *           *   *   *       *       *   *   * 
* * *   *   *   *   * * * * * * *   *   *   * * * * * * *   *   * * *   *   *   * * *   * * *   *   * 
*   *   *       *           *       *           *           *           *       *       *       *   * 
*   *   * * * * *   * * *   *   * * * * *   * * *   * * * * * * * * * * * * *   *   * * *   *   *   * 
*   *   *       *   *       *       *       *       *           *           *   *   *   *   *   *   * 
*   *   *   *   * * *   * * *   *   * * * * *   * * *   * * *   * * * * *   * * *   *   *   *   *   * 
*           *           *       *                       *               *           *       *       * 
* * * * * * * * * * * * * * * * * * * * * * * * * * * * * * * * * * * * * * * * * * * * * * * * * * * 