
* * * * * * * * * * * * * * * * * * * * * * * * * * * * * * * * * * * * * * * * * * * * * * * * * * * 
* S                                                         *           *       *       *           * 
*   *   *   * * * * *   * * * * *   * * *   * * *   *   *   *   *   *   *   *   *   *   * * *   *   * 
*   *   *   *   *   *           *   *           *   *   *   *   *   *   *   *       *       *   *   * 
*   *   *   *   *   * * * * *   *   * * *   *   *   *   * * *   *   * * *   * * * * * * *   *   * * * 
*   *   *   *   *                           *   *   *   *   *   *           *           *   *       * 
*   * * * * *   * * * * * * *   * * * * *   *   *   *   *   *   * * * * * * *   *   *   *   * * *   * 
*   *                           *   *       *   *   *   *   *                   *   *   *       *   * 
*   * * * * * * *   * * * * * * *   *   * * *   * * *   *   *   * * * * * * *   *   * * * * *   *   * 
*   *                           *       *       *   *   *   *   *           *   *           *   *   * 
*   *   * * * * * * * * * * *   * * * * *   * * *   *   *   *   *   * * *   *   * * * * *   *   *   * 
*   *   *               *       *       *       *       *               *       *       *       *   * 
*   *   *   * * * * * * *   *   *   *   * * *   * * *   * * * * * * *   * * * * *   *   * * *   *   * 
*   *           *           *   *   *       *       *   *       *       *           *       *   *   * 
*   *   * * * * *   * * * * *   *   * * *   * * *   *   *   *   * * *   *   * * * * * * *   *   *   * 
*   *   *       *               *       *           *       *       *   *       *           *   *   * 
*   *   *   *   *   * * * * * * *   * * * * * * *   * * * * * * *   * * * * *   *   * * * * *   *   * 
*       *   *   *   *           *   *           *   *               *           *       *   *   *   * 
* * * * *   *   *   * * * * * * *   *   * * *   * * *   * * * * * * *   * * * * * * *   *   *   *   * 
*           *   *   *               *   *   *       *   *               *           *   *       *   * 
*   * * * * *   *   *   * * * * * * *   *   * * *   *   *   * * * * * * * * *   * * *   *   * * *   * 
*   *       *       *       *   *       *       *   *   *   *                   *       *   *       * 
*   *   *   * * * * * * *   *   *   * * *   *   *   *   *   * * *   * * * * *   *   * * *   * * *   * 
*       *               *   *   *   *       *   *   *   *   *       *       *   *   *       *       * 
*   * * * * * * * * *   *   *   *   *   * * *   *   *   *   *   *   *   *   * * *   *   * * *   * * * 
*                   *       *   *   *       *       *           *   *   *           *       *       * 
* * * * *   * * * * * * * * *   *   * * *   * * * * * * *   * * * * *   * * * * * * * * *   * * *   * 
*       *           *           *       *       *       *   *       *       *           *       *   * 
*   *   *   * * * * *   * * *   * * *   * * *   *   *   * * *   *   * * *   *   * * * * * * *   *   * 
*   *   *   *           *           *   *   *       *           *           *   *           *       * 
* * *   *   *   *   * * * * * * *   *   *   * * * * * * * * * * * * * * * * *   *   * * *   * * *   * 
*       *   *   *   *       *   *   *   *   *                       *           *       *           * 
*   * * *   *   * * *   * * *   *   *   *   *   * * * * *   * * *   * * *   * * * * *   * * * * * * * 
*   *       *       *   *           *   *   *       *       *           *           *       *       * 
*   *   * * * * *   *   * * * * *   *   *   * * *   *   * * * * * * *   * * *   *   * * *   *   *   * 
*                   *           *   *   *       *   *               *       *   *       *       *   * 
* * * * * * * * * * * * * * *   * * *   *   * * *   * * * * * * *   * * *   * * * * *   * * * * *   * 
*                   *           *       *               *       *       *                   *       * 
*   * * * * * * *   *   * * * * *   * * *   * * * * * * *   *   * * *   * * * * * * * * *   *   * * * 
*           * E *       *           *   *   *       *       *           *           *       *       * 
* * * * *   *   * * * * * * *   *   *   *   *   *   *   * * * * * * * * *   * * *   *   * * * * *   * 
*       *   *               *   *   *       *   *   *   *               *       *   *           *   * 
* * *   *   * * *   * * *   * * *   *   * * *   * * *   *   * * * * *   * * *   *   * * * * *   *   * 
*       *   *       *   *           *   *           *       *   *       *       *   *           *   * 
*   * * *   *   * * *   * * * * * * *   *   * * *   * * * * *   *   * * *   * * *   * * *   * * *   * 
*   *       *   *               *       *       *       *       *       *   *   *       *   *       * 
*   *   * * *   *   *   * * * * *   * * * * * * *   *   * * *   * * *   *   *   * * *   * * *   * * * 
*   *           *   *               *           *   *       *       *   *       *       *       *   * 
*   * * * * * * *   * * * * * * * * * * *   *   *   * * *   * * *   *   * * *   *   * * *   * * *   * 
*                                           *       *               *           *                   * 
* * * * * * * * * * * * * * * * * * * * * * * * * * * * * * * * * * * * * * * * * * * * * * * * * * * 