
* * * * * * * * * * * * * * * * * * * * * * * * * * * * * * * * * * * * * * * * * * * * * * * * * * * 
* S                                                 *   *                                       *   * 
* * * * *   * * * * *   *   *   *   *   *   * * *   *   *   *   *   * * * * * * * * * * * * *   *   * 
*       *   *       *   *   *   *   *   *   *   *   *   *   *   *           *   *               *   * 
*   *   *   *   * * *   *   *   *   * * *   *   *   *   *   *   * * * * *   *   * * * * * * *   *   * 
*   *   *   *           *   *   *   *   *   *       *       *   *       *   *   *               *   * 
*   *   *   * * * * * * *   *   *   *   *   *   * * * * * * *   *   *   *   *   * * *   * * * * *   * 
*   *   *   *       *   *   *   *   *       *   *               *   *   *   *                       * 
*   *   *   *   *   *   *   *   *   * * * * *   *   * * * * * * *   *   *   *   * * * * *   * * *   * 
*   *   *   *   *   *   *   *   *   *           *               *   *       *   *           *       * 
*   *   *   *   *   *   *   *   *   * * *   * * * * * * * * *   *   * * * * *   * * * * * * * * * * * 
*   *           *       *   *   *       *                       *   *                   *           * 
*   * * * * * * * * *   *   *   *   *   * * * * * * * * * * * * *   *   * * * * * * *   *   * * *   * 
*   *           *   *       *       *   *   *                   *   *               *           *   * 
*   *   *   *   *   * * * * * * * * *   *   *   * * * * * * * * *   * * * * * * * * * * * * * * *   * 
*   *   *   *           *               *                   *   *   *                   *       *   * 
*   *   *   * * * * * * *   * * * * * * *   * * * * * * *   *   *   *   * * * * * * *   *   *   *   * 
*   *   *   *           *   *       *       *               *   *   *       *       *       *   *   * 
*   * * *   *   * * * * *   *   *   *   * * * * * * *   * * *   *   *   *   * * *   * * * * *   *   * 
*           *   *           *   *   *   *           *               *   *   *       *       *   *   * 
* * * * * * *   * * * * *   *   *   *   * * *   * * * * *   * * * * * * *   *   *   * * *   *   *   * 
*                           *   *   *           *       *   *               *   *       *   *   *   * 
*   * * * * * * * * * * * * *   * * * * * * *   *   *   *   * * * * * * * * *   * * *   *   *   *   * 
*   *                           *               *   *   *   *               *   *   *   *   *       * 
*   * * * * * * * * *   * * * * *   * * * * * * *   *   *   * * * * * * *   *   *   *   *   * * *   * 
*                   *   *                       *   *   *   *           *   *       *   *   *       * 
* * * * * * * * *   *   *   * * * * * * * * *   * * *   *   *   *   * * *   *   *   *   *   *   * * * 
*               *   *   *   *           *           *   *   *   *           *   *   *   *   *   *   * 
*   *   * * * * *   *   *   *   *   *   * * * * * * *   *   *   * * * * * * *   * * *   *   *   *   * 
*   *   *               *   *   *   *                   *   *   *               *       *   *   *   * 
*   *   *   *   *   *   *   *   *   * * * * * * * * * * *   *   *   * * * * * * *   * * *   *   *   * 
*   *   *   *   *   *   *   *   *   *   *                   *   *   *                       *   *   * 
*   *   *   * * *   *   * * *   * * *   * * * * * * *   * * *   *   *   * * * * * * * * * * *   *   * 
*   *   *   *   *   *   *       *               *   *   *       *                   *           *   * 
* * *   *   *   *   *   *   * * *   *   * * *   *   *   *   *   * * * * * * *   * * *   * * * * *   * 
*       *       *   *       *       *   *   *   *   *   *   *       *           *       *           * 
*   * * * * * * *   * * * * * * *   *   *   *   *   *   *   * * *   * * * * * * *   * * * * * * *   * 
*                   *           *   *   *   *   *       *       *   *           *   *               * 
*   * * *   * * *   *   * * *   * * *   *   *   *   * * * * * * *   *   * * *   *   * * *   * * *   * 
*   *       *   *   *   *   *           *       *           *       *       *   *           *   *   * 
*   *   * * *   *   *   *   *   * * * * * * * * * * * * *   *   * * * * *   *   * * * * * * *   *   * 
*   *   *   *               *   *                       *   *               *       *           *   * 
* * *   *   * * * * * * * * *   *   * * * * * * *   * * * * * * * * * * * * *   *   *   * * * * *   * 
*       *                   *   *   *   *       *                       *       *       *           * 
*   * * * * * * * * *   *   *   * * *   * * * * * * * * *   * * * * *   *   * * * * * * *   * * * * * 
*   *               *   *       *   *   *       *           *               *           *           * 
*   *   * * * * * * *   * * * * *   *   *   * * *   * * * * * * * * *   * * *   * * *   * * * * *   * 
*   *   *   *                   *   *   *       *   *                   *       *   *           *   * 
*   *   *   * * * * * * * * * * *   *   * * *   *   * * * * * * * * * * *   * * *   * * * * * * *   * 
*                                               *                                                 E * 
* * * * * * * * * * * * * * * * * * * * * * * * * * * * * * * * * * * * * * * * * * * * * * * * * * * 