
* * * * * * * * * * * * * * * * * * * * * * * * * * * * * * * * * * * * * * * * * * * * * * * * * * * 
* S                                                 *           *               *   *           *   * 
*   * * * * * * * * * * * * * * * * * * *   * * *   *   *   *   *   * * *   *   *   *   *   *   *   * 
*   *                                   *   *   *   *   *   *   *   *   *   *   *   *   *   *   *   * 
*   * * * * * * * * * * * * * * *   * * *   *   *   *   *   * * *   *   *   *   *   * * *   *   *   * 
*                       *       *           *       *   *           *   *   *   *   *       *   *   * 
*   * * * * * * * * * * * * *   * * * * * * *   * * *   * * * * * * *       *   *   *   * * *   *   * 
*   *               *           *                               *   *   *   *           *   *       * 
*   *   * * * * *   *   * * * * *   * * * * * * * * * * * * *   *   *   *   * * * * * * *   * * *   * 
*   *       *   *   *   *       *   *           *               *   *   *               *   *       * 
*   *   *   *   *   *   *   *   *   *   * * * * *   * * * * * * *   * * * * * * * * *   *   *   * * * 
*   *   *   *   *   *       *       *                       *                                       * 
*   *   *   *   *   * * *   * * * * * * * * * * * * *   *   * * * * * * *   * * * * * * *   * * * * * 
*   *   *   *   *       *       *                   *   *   *                   *       *   *       * 
*   *   * * *   * * *   * * *   *   * * * * * * *   *   *   *   * * * * * * *   *   *   *   *   *   * 
*   *               *   *   *   *   *           *   *   *   *               *   *   *   *   *   *   * 
*   * * * * * * * * *   *   *   *   * * * * *   *   *   *   *   * * * * *   *   *   *   *   *   *   * 
*   *   *               *   *   *               *   *   *   *           *   *   *   *   *       *   * 
*   *   *   * * * * * * *   *   * * * * * * *   *   *   *   * * * * * * *   * * * * *   * * * * *   * 
*       *   *               *   *               *       *   *       *   *   *   *   *   *   *   *   * 
*   *   *   * * * * * * *   *   *   * * * * * * * * * * *   *   *   *   *   *   *   *   *   *   *   * 
*   *   *                   *   *   *                       *   *   *   *   *   *   *   *   *       * 
*   *   *   * * * * * * * * *   *   *   * * * * * * * * * * *   *   *   *   *   *   *   *   * * *   * 
*   *   *   *       *           *       *                       *   *   *   *   *       *           * 
*   *   *   *   *   *   * * * * *   * * * * * * * * * * *   *   *   *   * * *   * * *   * * * * *   * 
*   *   *   *   *   *       *       *                       *   *           *       *       *   *   * 
*   * * *   *   *   * * *   *   * * * * * * * * * * *   * * *   *   * * *   * * *   * * *   *   *   * 
*   *   *   *   *           *               *       *   *   *   *   *   *       *       *       *   * 
* * *   *   * * *   * * * * * * * * * * *   *   *   *   *   * * * * *   * * *   * * *   *   * * *   * 
*   *   *       *   *               *       *   *       *                   *   *       *   *       * 
*   *   * * *   *   *   * * * * *   *   * * *   * * * * *   * * * * * * * * *   *   * * * * *   * * * 
*   *       *   *       *           *   *           *       *           *       *   *           *   * 
*   *   *   *   * * *   * * * * *   *   *   * * *   *   * * *   * * *   *   * * *   *   * * * * *   * 
*   *   *   *   *       *       *   *   *   *   *   *   *       *   *   *   *       *   *   *       * 
*   *   *   *   *   *   *   *   * * *   *   *   *   *   *   * * *   *   *   *   *   *   *   *   *   * 
*   *   *   *   *   *   *   *   *   *   *   *   *   *   *   *       *       *   *   *   *       *   * 
*   *   *   *   *   *   *   *   *   *   * * *   *   *   *   *   * * * * *   *   * * *   * * * * *   * 
*   *   *   *   *   *   *   *   *   *                   *   *   *           *       *           *   * 
*   *   *   *   *   * * *   * * *   * * * * * * * * * * *   *   *   * * * * * * *   * * * * *   *   * 
*       *   *           *                   *               *   *               *           *       * 
* * *   *   * * * * * * * * * * *   * * * * *   * * * * *   *   * * * * * * *   * * *   *   * * *   * 
*   *   *                       *   *           *           *               *   *       *   *       * 
*   *   * * * * * * * * *   * * *   * * * * *   * * * * * * * * * * * * *   *   *   * * *   *   * * * 
*   *       *       *       *   *   *       *       *               *       *   *   *       *   *   * 
*   *   *   *   *   *   * * *   *   *   *   *   *   *   *   * * *   *   *   *   *   * * * * *   *   * 
*   *   *   *   *   *           *       *   *   *   *   *       *   *   *   *   *           *   *   * 
*   *   *   *   * * * * * * * * *   * * *   * * *   *   * * *   *   *   *   *   * * * * *   *   *   * 
*   *   *   *                           *   *       *   *   *   *       *   *   *       *   *       * 
*   * * *   * * *   * * * * * * * * *   *   *   * * *   *   *   * * * * * * *   *   *   *   * * *   * 
*                                   *   *       *           *                       *   *         E * 
* * * * * * * * * * * * * * * * * * * * * * * * * * * * * * * * * * * * * * * * * * * * * * * * * * * 