
* * * * * * * * * * * * * * * * * * * * * * * * * * * * * * * * * * * * * * * * * * * * * * * * * * * 
* S                                                         *                   *               *   * 
*   * * * * * * *   * * * * * * * * *   * * * * * * * * *   *   * * *   * * * * * * * * * * *   *   * 
*   *                           *   *   *               *   *       *   *                   *   *   * 
*   * * * * * * * * *   * * * * *   *   * * * * * * *   *   * * *   *   *   * * * * * * *   *   *   * 
*   *               *               *   *               *       *   *   *   *           *   *   *   * 
*   *   * * * * * * * * * * * * *   *   * * * * *   * * * * * * *   *   *   * * * * *   *   *   *   * 
*   *                               *           *                   *   *               *   *   *   * 
*   * * * * * * * * * * * * * * *   *   * * * * * * *   * * * * * * *   *   * * * * * * * * *   *   * 
*           *   *           *       *               *       *       *       *       *       *       * 
* * * * *   *   *   * * *   *   *   * * * * * * *   * * * * *   *   * * *   *   *   *   *   * * *   * 
*   *       *   *   *   *   *   *       *       *               *       *   *   *   *   *       *   * 
*   *   * * *   *   *   *   *   * * * * *   * * * * * * * * * * * * *   * * *   *   *   * * *   *   * 
*   *   *       *   *   *   *   *           *                       *   *       *       *       *   * 
*   *   *   *   *   *   *   * * *   * * * * * * * * * * * * * * *   *   *   * * * * * * *   * * *   * 
*   *   *   *   *   *   *                                           *       *           *           * 
*   *   *   *   *   *   *   * * * * * * * * * * * * * * * * * * *   * * * * *   * * * * * * * * *   * 
*   *   *   *   *       *           *                                                       *       * 
*   *   *   * * * * *   *   * * * * *   * * * * * * *   * * * * *   * * * * * * * * * * *   *   * * * 
*       *   *                       *               *   *           *                       *   *   * 
*   * * *   *   * * * * * * * * * * *   * * * * *   *   * * * * *   *   * * * * * * * * *   *   *   * 
*   *       *                   *               *   *           *   *       *               *       * 
*   *   * * * * * * * * * * *   * * * * * * *   *   *   * * * * *   * * *   *   * * * * * * * * *   * 
*   *               **  *   *   *       *   *   *   *                   *   *           *       *   * 
*   * * * * * * *   *   *   *   *   *   *   *   *   * * * * * * * * *   *   *   * * *   *   *   *   * 
*   *               *   *   *       *   *   *   *               *       *   *   *   *       *   *   * 
*   *   * * * * * * *   *   * * * * *   *   *   *   * * * * * * *   * * *   *   *   * * * * *   *   * 
*       *           *   *           *   *       *           *               *   *   *       *   *   * 
* * * * *   * * * * *   *   * * * * *   * * * * * * * * *   *   * * * * * * *   *   * * *   *   *   * 
*   *               *   *   *       *   *               *   *   *   *       *               *       * 
*   *   * * * * *   *   *   *   *   *   *   * * * * *   *   *   *   *   *   * * * * * * *   * * * * * 
*   *   *       *       *   *   *   *   *   *           *           *   *           *   *   *       * 
*   *   *   *   * * * * *   *   *   *   *   *   * * * * * * * * *   *   * * * * *   *   *   *   *   * 
*   *       *           *       *   *       *               *       *       * E     *       *   *   * 
*   * * * * *   * * *   * * *   * * *   * * * * * * * * *   * * * * *   *   *   *   *   * * *   * * * 
*           *       *       *       *   *               *   *       *   *       *   *   *           * 
* * * * *   *   * * * * *   * * *   *   * * * * *   *   *   *   *   * * * * *   *   *   * * *   *   * 
*       *   *   *       *       *   *       *       *   *   *   *               *   *       *   *   * 
*   * * *   *   *   *   * * *   *   * * * * *   * * * * *   *   * * * * * * * * *   * * *   *   *   * 
*   *       *   *   *           *               *       *       *   *           *   *       *   *   * 
*   *   * * * * *   * * * * *   * * *   * * * * *   *   * * * * *   *   *   * * *   *   * * * * *   * 
*   *   *           *               *   *           *   *               *   *       *           *   * 
*   *   * * *   * * *   * * * * * * *   *   * * * * *   *   * * * * * * *   *   * * * * * * *   *   * 
*   *           *   *   *               *   *       *       *           *   *           *   *   *   * 
*   * * * * * * *   *   * * * * * * * * *   *   *   * * * * * * *   * * *   * * * * *   *   *   *   * 
*   *               *       *           *   *   *   *           *       *           *   *       *   * 
*   *   *   * * * * * * *   * * * * *   *   *   *   *   * * *   * * *   *   * * * * *   *   * * *   * 
*   *   *               *   *       *       *   *   *   *   *           *   *       *   *           * 
*   *   * * * * * * *   *   *   *   * * * * *   *   *   *   * * * * *   *   *   *   *   * * * * *   * 
*                   *           *               *       *               *       *       *           * 
* * * * * * * * * * * * * * * * * * * * * * * * * * * * * * * * * * * * * * * * * * * * * * * * * * * 