
* * * * * * * * * * * * * * * * * * * * * * * * * * * * * * * * * * * * * * * * * * * * * * * * * * * 
* S     *       *       *                                   *           *       *                   * 
*   *   *   *   *   *   *   *   * * * * * * * * * * * * *   *   *   *   *   *   * * * * *   * * *   * 
*   *       *       *       *       *                       *   *   *   *   *           *   *       * 
*   * * * * * * * * *   * * * * *   *   * * * * * * * * * * *   *   *   *   *   * * * * *   *   *   * 
*   *       *       *           *   *       *                   *   *   *   *   *           *   *   * 
*   *   * * *   *   * * * * *   *   * * *   * * * * * * *   *   *   *   *   *   * * * * * * *   *   * 
*   *       *   *           *   *       *   *           *   *   *   *   *   *               *   *   * 
*   *   *   *   * * * * *   * * * * *   *   * * * * *   *   *   *   *   *   * * * * * * *   *   * * * 
*   *   *   *   *               *       *               *   *   *   *   *   *           *   *       * 
*   * * *   *   * * * * * * *   *   * * * * * * * * * * *   *   *   *   *   *   * * * * *   *   *   * 
*   *       *               *   *   *                   *   *       *               *       *   *   * 
*   *   * * * * * * * * *   *   *   *   * * * * * * * * *   * * * * * * * * * * * * *   * * *   *   * 
*   *                   *   *       *   *                                               *   *   *   * 
*   *   * * * * * * *   *   * * * * *   *   * * * * * * * * * * * * * * * * * * * * * * *   *   *   * 
*   *   *               *           *   *                           *       *               *   *   * 
*   *   * * * * *   *   *   * * *   *   *   * * * * * * * * * * * * * * * * * * *   * * *   *   *   * 
*   *           *   *   *   *   *   *   *                       *                   *   *   *   *   * 
*   * * * * * * *   *   *   *   *   *   * * * * * * * * *   * * *   * * * * * * * * *   *   * * *   * 
*                   *           *   *                           *       *           *       *   *   * 
* * * * * * * * * * * * * * * * *   * * * * * * * * * * * * *   * * *   *   * * *   *   * * *   *   * 
*                                                                       *   *       *   *   *   *   * 
*   * * *   * * * * * * * * * * * * * * * * * * * * * * * * *   * * * * *   * * * * *   *   *   *   * 
*   *   *   *                   *                   *                   *               *   *       * 
*   *   *   * * * * * * * * *   *   * * * * * * * * * * * * *   * * *   *   * * * * * * *   *   *   * 
*   *   *                                               *           *   *   *   *           *   *   *
*   *   *   * * * * * * * * * * *   * * * * *   *   * * *   *   * * *   *   *   *   *   * * *   *   * 
*   *   *   *                   *   *           *       *   *   *       *   *   *   *       *   *   * 
*   *   *   *   * * * * *   * * *   * * * * *   * * *   * * *   *   *   *   *   * * * * *   *   *   * 
*   *   *   *   *       *   *   *   *       *       *   *   *   *   *   *   *               *   *   * 
*   *   *   *   *   *   * * *   *   *   *   * * * * *   *   *   *   *   *   * * * * * * *   *   * * * 
*   *   *   *   *   *           *   *   *           *   *   *       *   *   *           *   *       * 
*   *   * * *   *   * * *   * * *   * * * * * * *   *   *   * * * * *   *   *   * * *   *   * * *   * 
*           *   *   *   *   *   *   *               *   *                   *       *   *   *       * 
*   * * * * *   *   *   *   *   *   *   * * * * * * *   * * * * * * * * * * * * *   *   * * *   * * * 
*           *   *   *   *   *   *   *                       *       *           *   *       *       * 
* * * * * * *   *   *   *   *   *   * * * * * * * * * * *   *   *   *   *   *   *   * * *   *   *   * 
*           *   *       *   *                   *       *   *   *   *   *   *       *   *   *   *   * 
*   * * * * *   * * *   *   * * * * *   * * * * * * *   *   *   *   * * *   * * * * *   *   *   *   * 
*                   *   *   *       *               *       *   *           *           *   *   *   * 
*   * * * * * * * * *   *   *   *   * * * * * * *   * * * * *   * * * * * * *   *   * * *   * * *   * 
*   *                   *       *           *       *       *   *   *           *   *       *       * 
*   * * * * * * * * *   * * * * * * * * *   *   *   *   *   *   *   *   * * *   * * *   * * *   * * * 
*                       *           *   *   *   *       *       *   *   *   *       *   *           * 
* * * * * * * * * * * * *   *   *   *   *   *   *   *   * * * * *   *   *   * * *   *   * * * * *   * 
*       *                   *   *   *   *   *   *   *   *       *   *   *       *   *   *       *   * 
*   * * *   * * * * * * * * *   *   *   *   *   *   *   * * *   *   *   * * *   *   *   *   *   *   * 
*           *                   *   *   *   *   *   *   *   *   *   *       *   *       *   *       * 
*   * * * * * * * * * * *   * * * * *   * * * * * * *   *   *   *   * * *   *   * * * * *   * * *   * 
*               *                                           *   *                           *     E * 
* * * * * * * * * * * * * * * * * * * * * * * * * * * * * * * * * * * * * * * * * * * * * * * * * * * 