
* * * * * * * * * * * * * * * * * * * * * * * * * * * * * * * * * * * * * * * * * * * * * * * * * * * 
* S                                     *                               *       *                   * 
*   * * * * * * * * * * *   * * * * *   *   * * * * * * *   * * * * *   *   *   *   * * * * * * *   * 
*                       *   *       *           *       *   *           *   *       *       *       * 
*   * * * * * * * * *   *   *   *   * * * * *   * * *   *   * * * * *   *   * * * * * * *   *   * * * 
*       *           *       *   *               *       *           *       *               *   *   * 
* * * * *   * * * * * * *   *   *   * * * * * * *   * * * * *   *   * * * * *   *   * * * * *   *   * 
*           *           *   *   *   *       *       *       *   *   *       *   *               *   * 
*   * * * * *   * * *   *   *   *   *   *   * * *   *   *   *   *   *   *   *   * * * * * * * * *   * 
*   *           *   *   *   *   *   *   *           *   *   *   *   *   *   *   *                   * 
*   * * * * *   *   *   *   *   * * *   * * * * *   *   *   * * *   *   * * *   * * *   * * *   * * * 
*       *       *       *   *           *       *   *   *           *               *   *   *       * 
*   *   *   * * *   * * *   * * * * * * *   *   *   *   * * * * * * * * * * * * *   *   *   *   *   * 
*   *   *   *       *               *       *       *           *           *   *   *   *   *   *   * 
*   *   *   * * * * *   * * * * * * *   * * * * * * *   * * *   *   * * *   *   *   * * *   *   *   * 
*   *   *               *       *       *           *       *   *   *   *   *           *   *   *   * 
*   *   * * * * * * * * *   *   *   * * *   * * *   * * *   *   *   *   *   * * * * *   *   * * *   * 
*   *   *           *       *   *   *       *   *   *       *           *       *       *   *       * 
*   *   *   * * *   *   * * *   *   *   * * *   *   * * * * * * * * * * * * *   *   * * * * *   *   * 
*   *   *   *   *       *   *       *   *   *       *                           *   *           *   * 
*   *   *   *   * * * * *   * * * * *   *   *   * * *   * * * * * * * * * * * * *   *   * * * * *   * 
*   *                   *   *       *   *   *   *       *                       *   *       *       * 
*   * * * * * * * * *   *   *   *   * * *   *   *   * * * * * * * * *   * * *   *   * * *   *   * * * 
*   *                       *   *           *       *                   *       *       *   *   *   * 
*   *   * * * * * * * * *   *   * * * * * * * * * * *   * * * * * * *   *   * * * * *   *   *   *   * 
*   *           *           *                   *       *               *   *   *       *   *   *   * 
*   * * * * * * * * *   * * * * * * *   * * *   *   * * * * * * * * *   *   *   *   * * *   *   *   * 
*   *       *       *       *               *   *       *               *       *   *       *   *   * 
*   *   * * * * *   * * * * * * * * * * *   *   *   *   * * * * *   * * * * * * *   * * *   *   *   * 
*   *           *       *       *       *   *   *   *           *   *               *       *   *   * 
*   * * *   *   * * *   *   * * * * *   * * *   *   * * * * *   *   *   * * * * * * *   * * *   *   * 
*           *       *   *   *       *   *       *   *       *   *   *       *       *   *   *   *   * 
* * * * * * * * * * *   *   *   *   *   *   * * *   *   * * *   * * * * *   *   *   *   *   *   *   * 
*                   *   *       *   *       *       *   *       *           *   *       *   *       * 
*   *   * * * * * * *   *   * * *   * * * * * * *   *   *   * * *   * * * * *   * * * * *   *   *   * 
*   *           *       *       *   *           *   *   *   *       *           *       *       *   * 
*   * * * * * * * * * * * * *   *   *   * * *   *   *   *   *   * * * * *   * * *   * * * * *   *   * 
*   * E                     *   *   *   *       *       *   *               *       *           *   * 
*   *   * * *   * * * * *   * * *   *   *   * * * * * * *   * * * * * * * * * * *   *   * * * * *   * 
*               *       *           *   *   *                                   *   *   *           * 
*   * * * * *   *   * * * * * * * * *   *   * * *   * * *   * * * * * * * * *   *   *   * * * * *   * 
*   *                       *           *           *       *           *       *   *   *       *   * 
*   * * * * * * * * *   * * *   * * *   *   * * * * * * * * *   * * *   *   * * *   *   *   *   *   * 
*   *                           *   *   *   *           *       *   *   *           *       *       * 
*   *   * * * * * * * * * * * * *   *   * * *   * * *   *   * * *   *   * * * * *   * * * * * * *   * 
*   *       *                   *   *           *       *   *       *   *                   *       * 
*   * * * * * * * * * * * * *   *   * * * * * * *   * * *   *   * * *   * * * * * * * * * * *   * * * 
*                           *   *               *       *   *       *   *                   *       * 
*   * * * * * * * * * * *   *   * * * * * * *   * * *   *   * * *   *   *   * * * * * * *   * * *   * 
*                           *                       *               *                   *           * 
* * * * * * * * * * * * * * * * * * * * * * * * * * * * * * * * * * * * * * * * * * * * * * * * * * * 