
* * * * * * * * * * * * * * * * * * * * * * * * * * * * * * * * * * * * * * * * * * * * * * * * * * * 
* S	                                                    *                       *                   * 
* * * * * * * * * * * * * * * * *   * * * * * * *   * * *   * * * * * * *   *   * * * * *   * * *   * 
*           *                       *           *       *   *   *           *               *       * 
*   * * * * * * * * * * * * * * *   *   * * * * * * *   *   *   *   * * * * * * * * * * * * *   * * * 
*   *       *   *   *       *       *               *       *   *           *               *       * 
*   *   *   *   *   * * *   *   * * * * * * *   *   * * * * *   * * * * *   *   * * * * *   * * *   * 
*   *   *   *               *               *   *                   *       *   *       *   *   *   * 
*   * * *   * * * * * * * * * * * * * * *   *   *   * * * * * * * * *   *   *   *   * * *   *   *   * 
*                           *           *   *   *       *       *       *   *       *       *       * 
*   * * * * *   * * * * *   *   *   *   *   * * *   *   *   *   *   * * *   * * *   *   * * * * * * * 
*   *                       *   *   *   *       *   *       *   *   *       *       *               * 
*   * * * * * * * * * * *   *   *   *   * * *   *   * * * * *   *   * * * * *   * * * * * * * * *   * 
*   *                   *       *   *   *   *   *   *           *   *           *   *               * 
*   * * * * * * *   * * * * * * *   *   *   *   * * *   * * *   *   *   * * * * *   *   * * * * * * * 
*               *   *       *       *       *   *       *       *   *           *   *               * 
*   * * * * *   *   *   *   *   *   * * * * *   *   * * *   * * *   * * * * *   *   * * * * *   *   * 
*   *           *   *   *       *   *       *   *   *       *           *       *           *   *   * 
*   * * * * *   *   *   * * * * * * *   *   *   *   * * * * *   * * * * *   * * *   *   *   * * *   * 
*       *       *   *                   *           *       *           *   *       *   *   *       * 
* * *   *   * * * * * * * * * * * * * * * * * * * * *   *   * * * * *   *   *   * * * * *   *   * * * 
*   *   *                   *               *           *               *   *   *               *   * 
*   *   *   * * * * *   *   * * * * * * *   *   * * * * *   * * * * * * *   *   * * * * * * * * *   * 
*   *   *           *   *                                   *           *       *                   * 
*   *   * * * * *   *   * * *   * * * * * * * * * * * * *   *   *   *   * * * * * * * * * * * * *   * 
*   *   *           *   *       *                       *   *   *   *       *                       * 
*   *   * * * * * * *   *   * * *   * * * * * * * * *   *   *   *   *   * * *   * * * * * * * * *   * 
*   *       *           *       *       *                   *   *   *           *   *           *   * 
*   * * *   *   * * * * *   * * *   * * * * * * * * * * *   * * *   * * * * * * *   *   * * * * *   * 
*           *   *       *   *   *   *   *               *           *           *       *       *   * 
*   * * * * *   *   *   *   *   *   *   *   * * * * *   *   * * *   *   *   *   * * *   *   *   *   * 
*   *           *   *       *   *       *   *   *       *   *       *   *   *       *   *   *   *   * 
*   *   * * * * * * * * *   *   *   * * *   *   *   * * * * *   * * *   *   * * *   *   *   *   *   * 
*   *       *           *   *   *   *   *   *   *               *       *   *   *   *   *   *   *   * 
*   * * *   *   * * *   *   *   *   *   *   *   * * * * * * * * * * * * *   *   *   * * *   *   *   * 
*           *       *   *   *   *   *   *   *                   *           *   *           *       * 
* * * * *   * * *   *   * * *   *   *   *   *   * * * * *   *   *   * * * * *   * * * * * * * * *   * 
*           *       *           *   *   *   *   *           *       *                   *   *       * 
*   * * * * *   * * * * * * * * *   *   * * * * *   * * * * * * * * *   * * * * *   *   *   *   *   * 
*           *       *               *               *                   *           *       *   *   * 
* * * * *   * * *   *   * * * * * * *   *   * * * * * * *   * * * * * * *   * * *   * * * * *   *   * 
*               *   *           *       *   *           *       *           *       *           *   * 
* * * * * * *   *   * * * * *   *   *   * * *   * * *   *   * * *   *   * * * * * * *   * * * * *   * 
*           *   *           *   *   *               *   *   *       *   *           *       *       * 
*   * * *   * * *   * * *   *   *   * * * * * * * * *   *   *   *   * * *   * * *   * * *   * * *   * 
*   *               *       *   *       *           *   *   *   *   *       *   *       *           * 
*   *   * * * * * * * * * * *   * * *   *   * * *   *   *   *   * * *   * * *   *   * * * * * * *   * 
*   *   *       *           *   *       *   *   *       *   *       *           *   *           *   * 
*   * * *   *   *   * * *   *   * * * * *   *   * * * * *   * * *   * * * * *   *   *   *   * * *   * 
*           *           *                   *                   *               *       *         E * 
* * * * * * * * * * * * * * * * * * * * * * * * * * * * * * * * * * * * * * * * * * * * * * * * * * * 