
* * * * * * * * * * * * * * * * * * * * * * * * * * * * * * * * * * * * * * * * * * * * * * * * * * * 
* S                                                         *                           *           * 
*   * * * * * * * * * * *   * * * * * * * * * * *   *   *   *   *   * * * * * * *   *   * * * * *   * 
*                       *   *                       *   *   *   *               *   *               * 
*   * * * * * * * * *   *   * * * * *   * * * * * * *   *   *   * * * * * * * * *   * * * * * * *   * 
*   *                               *                   *       *           *       *           *   * 
*   * * * * * * *   * * *   * * *   * * * * * * * * *   *   *   *   * * * * * * * * *   *   * * *   * 
*       *           *   *   *                               *                           *   *       * 
*   *   *   * * * * *   *   * * * * * * * * * * * * * * * * * * * * * * * * *   * * *   *   *   * * * 
*   *   *   *                                   *       *       *           *   *   *   *   *   *   * 
*   *   *   *   * * * * * * * * *   * * * * * * *   *   * * *   *   * * *   *   *   *   * * *   *   * 
*   *       *                   *                   *       *   *   *   *   *   *   *   *       *   * 
*   * * * * * * * * * * * * * * *   * * * * * * * * * * *   *   *   *   * * *   *   *   *   * * *   * 
*   *               *           *       *           *       *   *   *           *   *       *       * 
*   * * *   * * *   *   * * *   * * *   *   * * *   *   * * *   *   * * * * *   *   * * * * *   *   * 
*       *   *       *   *           *   *   *       *   *   *   *               *           *   *   * 
* * *   *   *   * * *   * * * * *   *   *   *   * * *   *   * * *   * * * * * * *   * * *   *   *   * 
*   *       *   *   *       *   *   *   *   *   *   *   *   *   *   *               *   *   *   *   * 
*   * * * * *   *   * * *   *   *   *   *   *   *   *   *   *   *   * * * * * * * * *   *   *   *   * 
*   *           *       *   *   *   *   *   *       *   *   *               *       *   *   *   *   * 
*   *   * * * * * * *   *   *   *   *   *   * * * * *   *   *   * * * * * * *   *   *   *   *   *   * 
*   *   *               *   *   *   *   *   *   *   *       *   *               *   *           *   * 
*   *   *   * * * * *   *   *   *   *   *   *   *   *   *   * * *   * * * * * * *   * * *   *   *   * 
*   *   *               *       *       *   *   *   *   *   *       *           *       *   *   *   * 
*   *   * * * * * * * * * * *   * * *   *   *   *   *   *   *   * * * * * * *   * * *   *   *   *   * 
*   *   *       *                           *       *   *       *               *   *   *   *       * 
*   *   *   * * * * * * * * * * * * *   *   *   * * *   * * * * *   * * * * *   *   *   *   *   * * * 
*   *       *                           *                       *   *                   *   *   *   * 
*   * * *   *   * * * * * * * * * * *   * * * * * * * * * * *   *   * * * * * * * * *   *   *   *   * 
*   *   *   *       *               *   *           *   *           *                       *   *   * 
*   *   *   * * *   * * * * * * *   *   *   * * *   *   *   * * * * *   * * * * * * * * *   *   *   * 
*   *   *   *       *                   *       *   *   *   *   *       * E             *   *       * 
*   *   *   *   *   * * * * * * * * * * * * *   *   *   *   *   *   * * *   * * * * *   *   * * *   * 
*           *   *   *                           *   *           *   *               *       *   *   * 
*   * * * * *   * * *   * * * * * * * * * * * * *   * * * * *   *   *   * * *   *   * * * * *   *   * 
*                   *   *               *       *       *       *   *       *   *   *   *       *   * 
*   * * * * * * *   *   *   *   * * * * *   * * * * *   *   * * *   *   * * *   *   *   *   * * *   * 
*   *               *   *   *   *                       *   *       *   *       *   *   *           * 
*   *   * * * * *   * * *   *   * * * * *   * * * * * * *   *   * * * * *   * * *   *   * * * * *   * 
*   *   *               *   *               *       *   *   *           *       *               *   * 
*   * * * * *   * * * * *   *   * * * * * * *   *   *   *   * * * * *   *   *   * * * * * * *   *   * 
*   *       *   *           *   *               *   *           *       *   *   *       *       *   * 
*   *   *   *   *   * * * * *   * * * * * * * * *   * * * * * * *   * * * * *   * * *   *   * * *   * 
*   *   *   *   *           *   *               *               *           *       *           *   * 
*   *   *   *   * * * * *   *   * * *   * * * * * * * * * * *   * * * * *   *   *   * * * * *   *   * 
*       *   *           *   *           *                       *           *   *           *   *   * 
*   *   *   * * * * * * *   *   *   *   * * * * * * *   * * * * *   * * * * *   * * * * * * * * *   * 
*   *   *               *       *   *                   *           *                           *   * 
* * * * * * * * * * *   * * * * *   *   * * * * * * * * * * * * * * *   * * * * * * * * * * * * *   * 
* E                                 *       *                       *                               * 
* * * * * * * * * * * * * * * * * * * * * * * * * * * * * * * * * * * * * * * * * * * * * * * * * * * 