
* * * * * * * * * * * * * * * * * * * * * * * * * * * * * * * * * * * * * * * * * * * * * * * * * * * 
* S     *                                                                                           * 
*   *   * * * * * * *   * * * * * * * * * * * * *   * * * * * * * * * * *   * * * * * * * * * * *   * 
*   *               *   *       *                                       *                   *   *   * 
*   * * * * * * * * *   * * *   *   * * * * * * * * * * * * * * *   *   *   * * * * * * * * *   *   * 
*   *               *   *   *   *   *                   *           *   *       *               *   * 
*   *   *   * * * * *   *   *   *   * * * * * * * * *   * * * * *   *   * * *   * * * * *   *   *   * 
*   *   *   *       *       *   *   *                   *           *       *   *   *       *   *   * 
*   * * *   *   *   * * * * *   *   *   * * * * * * *   *   * * *   * * *   * * *   *   *   *   *   * 
*   *       *   *           *   *   *   *   *           *   *       *       *   *   *   *   *   *   * 
*   *   *   *   * * * * * * *   * * *   *   *   *   *   *   *   * * *   * * *   *   *   *   *   *   * 
*   *   *   *   *               *       *   *   *   *   *   *   *   *   *       *       *   *   *   * 
*   *   * * *   *   * * * * * * * * *   *   *   *   *   *   *   *   *   *   * * * * * * *   * * *   * 
*   *           *   *                   *   *   *   *   *   *   *   *   *               *           * 
*   *   * * * * *   *   * * * * * * * * *   *   * * *   *   * * *   *   * * * * * * *   * * * * * * * 
*   *   *       *       *           *       *       *   *   *           *           *   *           * 
*   * * *   *   * * * * * * *   *   *   *   *   *   * * *   *   * * * * * * *   *   *   *   * * *   * 
*           *           *   *   *   *   *   *   *           *           *       *   *   *   *   *   * 
*   * * * * * * * * *   *   *   *   * * *   *   * * * * * * * * * * *   *   * * * * *   *   *   *   * 
*   *               *   *       *           *       *       *           *   *       *           *   * 
*   * * *   * * *   *   *   * * * * * * * * * * *   * * *   *   * * * * *   *   *   * * * * * * *   * 
*       *   *       *   *   *                   *           *   *       *   *   *   *               * 
* * *   *   * * * * *   *   *   * * * * * * *   * * * * * * *   *   *   *   *   *   *   * * * * *   * 
*       *   *                   *           *                   *   *       *   *       *       *   * 
*   * * *   *   * * * * * * * * *   *   * * * * * * * * *   * * *   * * *   *   * * * * *   * * *   * 
*   *       *               *       *   *       *       *           *       *                       * 
*   *   *   * * * * * * * * * * * * *   *   *   *   *   * * * * * * *   * * * * * * * * * * *   * * * 
*       *   *                           *   *       *       *                                   *   * 
* * * * *   * * * * * * * * * * *   * * *   * * * * * * *   *   *   * * * * * * * * * * * * *   *   * 
*   *       *                       *       *           *       *   *               *       *       * 
*   *   * * *   * * *   * * * * * * *   * * * * * * *   * * * * *   *   * * * * *   *   *   * * * * * 
*   *   *       *                   *   *                   *   *   *       *       *   *           * 
*   *   *   *   * * * * * * *   * * *   *   * * * * * * *   *   *   * * *   *   * * * * * * * * *   * 
*   *   *   *       *           *       *   *       *           *       *   *                       * 
*   *   * * * * *   * * * * * * *   * * *   *   *   * * * * * * * * *   *   * * * * * * * * * * *   * 
*   *   *           *               *       *   *                   *   *               *           * 
*   *   *   * * * * *   * * * * * * *   *   *   * * * * * * * * *   *   *   * * * * *   * * * * *   * 
*           *                   *   *   *   *       *           *       *       *       *           * 
*   * * * * *   * * * * * * * * *   *   *   * * *   * * *   *   * * * * * * * * *   * * *   * * * * * 
*       *       *                       *               *   *                   *       *           * 
* * * * *   * * * * * * *   * * * * * * * * * * * * *   *   * * *   * * * * *   *   *   *   * * * * * 
*           *   *           *       *           *   *   *   *       *   *       *   *   *           * 
*   * * * * *   *   * * * * *   *   *   * * *   *   *   * * *   * * *   *   * * * * *   * * * * *   * 
*       *   *       *       *   *   *       *   *   *           *       *               *       *   * 
*   *   *   *   * * *   *   *   *   * * *   *   *   * * * * *   *   *   * * * * * * * * *   *   *   * 
*   *   *   *   *       *       *           *   *   *           *   *   *           *       *       * 
*   *   *   *   *   * * * * * * * * * * * * *   *   * * * * *   * * *   *   * * *   *   * * * * * * * 
*   *   *       *   *                       *   *               *   *       *   *       *           * 
*   *   * * * * *   * * * * * * * * * * *   *   * * * * * * * * *   *   * * *   * * * * *   * * *   * 
* E *                                       *                       *                       *       * 
* * * * * * * * * * * * * * * * * * * * * * * * * * * * * * * * * * * * * * * * * * * * * * * * * * * 